parliamentary_constituency_name,All Premises,All Matched Premises,Number of premises with 30<300Mbit/s download speed,Number of premises with >=300Mbit/s download speed,Number of premises with 0<2Mbit/s download speed,Number of premises with 2<5Mbit/s download speed,Number of premises with 5<10Mbit/s download speed,Number of premises with 10<30Mbit/s download speed,Number of premises with SFBB availability,Number of premises with UFBB availability,Number of premises unable to receive 2Mbit/s,Number of premises unable to receive 5Mbit/s,Number of premises unable to receive 10Mbit/s,Number of premises unable to receive 30Mbit/s,Number of premises with Full Fibre availability,Number of premises below the USO,Number of premises with NGA,Number of premises able to receive decent broadband from FWA,Number of premises able to receive SFBB from FWA,% of premises with 30<300Mbit/s download speed,% of premises with >=300Mbit/s download speed,% of premises with 0<2Mbit/s download speed,% of premises with 2<5Mbit/s download speed,% of premises with 5<10Mbit/s download speed,% of premises with 10<30Mbit/s download speed,SFBB availability (% premises),UFBB availability (% premises),% of premises unable to receive 2Mbit/s,% of premises unable to receive 5Mbit/s,% of premises unable to receive 10Mbit/s,% of premises unable to receive 30Mbit/s,Full Fibre availability (% premises),% of premises below the USO,% of premises with NGA,% of premises able to receive decent broadband from FWA,% of premises able to receive SFBB from FWA
ABERAVON,33018,33012,7715,24470,23,35,46,723,32185,24470,23,58,104,827,512,158,32681,6273,4659,23.4,74.1,0.1,0.1,0.1,2.2,23.4,74.1,0.1,0.2,0.3,2.5,1.6,0.5,99.0,19.0,14.1
ABERCONWY,30142,30121,26054,1777,182,427,369,1312,27831,1777,182,609,978,2290,1777,1098,29229,14667,11492,86.4,5.9,0.6,1.4,1.2,4.4,86.4,5.9,0.6,2.0,3.2,7.6,5.9,3.6,97.0,48.7,38.1
ABERDEEN NORTH,56487,56402,42398,11228,0,5,373,2398,53626,11228,0,5,378,2776,4512,505,54637,0,0,75.1,19.9,0.0,0.0,0.7,4.2,75.1,19.9,0.0,0.0,0.7,4.9,8.0,0.9,96.7,0.0,0.0
ABERDEEN SOUTH,52955,52926,35804,13499,19,80,97,3427,49303,13499,19,99,196,3623,11714,256,51358,0,0,67.6,25.5,0.0,0.2,0.2,6.5,67.6,25.5,0.0,0.2,0.4,6.8,22.1,0.5,97.0,0.0,0.0
AIRDRIE AND SHOTTS,41042,41039,15089,24636,22,110,177,1005,39725,24636,22,132,309,1314,478,333,40764,0,0,36.8,60.0,0.1,0.3,0.4,2.4,36.8,60.0,0.1,0.3,0.8,3.2,1.2,0.8,99.3,0.0,0.0
ALDERSHOT,46951,46931,7945,37814,41,283,256,592,45759,37814,41,324,580,1172,1368,621,45915,0,0,16.9,80.5,0.1,0.6,0.5,1.3,16.9,80.5,0.1,0.7,1.2,2.5,2.9,1.3,97.8,0.0,0.0
ALDRIDGE-BROWNHILLS,34640,34638,8679,25640,4,6,24,285,34319,25640,4,10,34,319,5928,40,34575,0,0,25.1,74.0,0.0,0.0,0.1,0.8,25.1,74.0,0.0,0.0,0.1,0.9,17.1,0.1,99.8,0.0,0.0
ALTRINCHAM AND SALE WEST,44893,44798,15798,27380,48,311,57,1204,43178,27380,48,359,416,1620,515,569,44220,560,0,35.2,61.0,0.1,0.7,0.1,2.7,35.2,61.0,0.1,0.8,0.9,3.6,1.1,1.3,98.5,1.2,0.0
ALYN AND DEESIDE,39692,39669,31445,5631,120,191,385,1897,37076,5631,120,311,696,2593,3290,741,38979,12017,911,79.2,14.2,0.3,0.5,1.0,4.8,79.2,14.2,0.3,0.8,1.8,6.5,8.3,1.9,98.2,30.3,2.3
AMBER VALLEY,43520,43471,29427,11373,50,144,341,2136,40800,11373,50,194,535,2671,11263,593,43013,0,0,67.6,26.1,0.1,0.3,0.8,4.9,67.6,26.1,0.1,0.4,1.2,6.1,25.9,1.4,98.8,0.0,0.0
ANGUS,46379,46065,38796,583,721,1242,1653,3070,39379,583,721,1963,3616,6686,583,4055,43494,0,0,83.6,1.3,1.6,2.7,3.6,6.6,83.6,1.3,1.6,4.2,7.8,14.4,1.3,8.7,93.8,0.0,0.0
ARFON,29670,29644,23148,4119,128,225,357,1667,27267,4119,128,353,710,2377,3569,764,28551,7733,2825,78.0,13.9,0.4,0.8,1.2,5.6,78.0,13.9,0.4,1.2,2.4,8.0,12.0,2.6,96.2,26.1,9.5
ARGYLL AND BUTE,56131,54748,42294,488,1876,1702,2935,5453,42782,488,1876,3578,6513,11966,487,8213,49017,0,0,75.3,0.9,3.3,3.0,5.2,9.7,75.3,0.9,3.3,6.4,11.6,21.3,0.9,14.6,87.3,0.0,0.0
ARUNDEL AND SOUTH DOWNS,48462,48406,41087,2583,200,408,624,3504,43670,2583,200,608,1232,4736,2290,1323,47726,0,0,84.8,5.3,0.4,0.8,1.3,7.2,84.8,5.3,0.4,1.3,2.5,9.8,4.7,2.7,98.5,0.0,0.0
ASHFIELD,50082,50064,7096,42129,10,215,51,563,49225,42129,10,225,276,839,564,294,49624,0,0,14.2,84.1,0.0,0.4,0.1,1.1,14.2,84.1,0.0,0.4,0.6,1.7,1.1,0.6,99.1,0.0,0.0
ASHFORD,55373,55332,25061,25030,189,755,1001,3296,50091,25030,189,944,1945,5241,2831,2066,54570,0,0,45.3,45.2,0.3,1.4,1.8,6.0,45.3,45.2,0.3,1.7,3.5,9.5,5.1,3.7,98.5,0.0,0.0
ASHTON-UNDER-LYNE,47746,47663,14067,33046,1,8,33,508,47113,33046,1,9,42,550,12494,125,47451,0,0,29.5,69.2,0.0,0.0,0.1,1.1,29.5,69.2,0.0,0.0,0.1,1.2,26.2,0.3,99.4,0.0,0.0
AYLESBURY,53441,53429,19658,31571,35,232,311,1622,51229,31571,35,267,578,2200,3914,611,52757,0,0,36.8,59.1,0.1,0.4,0.6,3.0,36.8,59.1,0.1,0.5,1.1,4.1,7.3,1.1,98.7,0.0,0.0
"AYR, CARRICK AND CUMNOCK",47970,47886,27072,17497,304,606,672,1735,44569,17497,304,910,1582,3317,324,1757,46766,0,0,56.4,36.5,0.6,1.3,1.4,3.6,56.4,36.5,0.6,1.9,3.3,6.9,0.7,3.7,97.5,0.0,0.0
BANBURY,58356,58313,38721,16405,131,87,432,2537,55126,16405,131,218,650,3187,4430,744,56968,0,0,66.4,28.1,0.2,0.1,0.7,4.3,66.4,28.1,0.2,0.4,1.1,5.5,7.6,1.3,97.6,0.0,0.0
BANFF AND BUCHAN,46438,46199,37969,845,1081,1498,1631,3175,38814,845,1081,2579,4210,7385,845,4605,43832,0,0,81.8,1.8,2.3,3.2,3.5,6.8,81.8,1.8,2.3,5.6,9.1,15.9,1.8,9.9,94.4,0.0,0.0
BARKING,53351,53342,5450,47339,1,82,58,412,52789,47339,1,83,141,553,23731,177,52794,0,0,10.2,88.7,0.0,0.2,0.1,0.8,10.2,88.7,0.0,0.2,0.3,1.0,44.5,0.3,99.0,0.0,0.0
BARNSLEY CENTRAL,44546,44531,10877,33139,0,41,57,417,44016,33139,0,41,98,515,896,138,44312,0,0,24.4,74.4,0.0,0.1,0.1,0.9,24.4,74.4,0.0,0.1,0.2,1.2,2.0,0.3,99.5,0.0,0.0
BARNSLEY EAST,44198,44192,16417,27030,14,41,29,661,43447,27030,14,55,84,745,15146,123,43938,0,0,37.1,61.2,0.0,0.1,0.1,1.5,37.1,61.2,0.0,0.1,0.2,1.7,34.3,0.3,99.4,0.0,0.0
BARROW AND FURNESS,45993,45953,44190,375,125,108,163,992,44565,375,125,233,396,1388,375,445,45859,1164,367,96.1,0.8,0.3,0.2,0.4,2.2,96.1,0.8,0.3,0.5,0.9,3.0,0.8,1.0,99.7,2.5,0.8
BASILDON AND BILLERICAY,43540,43515,14310,26918,13,162,425,1687,41228,26918,13,175,600,2287,6888,654,42966,0,0,32.9,61.8,0.0,0.4,1.0,3.9,32.9,61.8,0.0,0.4,1.4,5.3,15.8,1.5,98.7,0.0,0.0
BASINGSTOKE,52127,52122,21579,29959,0,86,177,321,51538,29959,0,86,263,584,8705,307,51858,0,0,41.4,57.5,0.0,0.2,0.3,0.6,41.4,57.5,0.0,0.2,0.5,1.1,16.7,0.6,99.5,0.0,0.0
BASSETLAW,50994,50928,33452,15200,207,139,178,1752,48652,15200,207,346,524,2276,1935,605,50687,3628,2656,65.6,29.8,0.4,0.3,0.3,3.4,65.6,29.8,0.4,0.7,1.0,4.5,3.8,1.2,99.4,7.1,5.2
BATH,45382,45363,15802,27538,0,1,174,1848,43340,27538,0,1,175,2023,11109,337,43952,0,0,34.8,60.7,0.0,0.0,0.4,4.1,34.8,60.7,0.0,0.0,0.4,4.5,24.5,0.7,96.8,0.0,0.0
BATLEY AND SPEN,49439,49430,15418,32598,1,24,91,1298,48016,32598,1,25,116,1414,11501,289,48765,165,0,31.2,65.9,0.0,0.0,0.2,2.6,31.2,65.9,0.0,0.1,0.2,2.9,23.3,0.6,98.6,0.3,0.0
BATTERSEA,61511,61314,5792,54160,0,0,18,1344,59952,54160,0,0,18,1362,17829,326,59954,0,0,9.4,88.0,0.0,0.0,0.0,2.2,9.4,88.0,0.0,0.0,0.0,2.2,29.0,0.5,97.5,0.0,0.0
BEACONSFIELD,46600,46593,27997,14485,32,180,652,3247,42482,14485,32,212,864,4111,4437,976,45670,0,0,60.1,31.1,0.1,0.4,1.4,7.0,60.1,31.1,0.1,0.5,1.9,8.8,9.5,2.1,98.0,0.0,0.0
BECKENHAM,40695,40691,8275,31942,2,3,23,446,40217,31942,2,5,28,474,395,32,40404,0,0,20.3,78.5,0.0,0.0,0.1,1.1,20.3,78.5,0.0,0.0,0.1,1.2,1.0,0.1,99.3,0.0,0.0
BEDFORD,49853,49848,4803,44336,25,66,49,569,49139,44336,25,91,140,709,2996,286,49308,0,0,9.6,88.9,0.1,0.1,0.1,1.1,9.6,88.9,0.1,0.2,0.3,1.4,6.0,0.6,98.9,0.0,0.0
BELFAST EAST,47236,47080,3920,41921,8,100,134,997,45841,41921,8,108,242,1239,18159,532,46093,0,0,8.3,88.7,0.0,0.2,0.3,2.1,8.3,88.7,0.0,0.2,0.5,2.6,38.4,1.1,97.6,0.0,0.0
BELFAST NORTH,52429,52234,3383,47943,15,25,328,540,51326,47943,15,40,368,908,26640,671,51405,0,0,6.5,91.4,0.0,0.0,0.6,1.0,6.5,91.4,0.0,0.1,0.7,1.7,50.8,1.3,98.0,0.0,0.0
BELFAST SOUTH,57114,56840,5931,49412,0,28,161,1308,55343,49412,0,28,189,1497,19647,594,55427,0,0,10.4,86.5,0.0,0.0,0.3,2.3,10.4,86.5,0.0,0.0,0.3,2.6,34.4,1.0,97.0,0.0,0.0
BELFAST WEST,41553,41380,4461,36452,14,35,20,398,40913,36452,14,49,69,467,15175,255,41022,0,0,10.7,87.7,0.0,0.1,0.0,1.0,10.7,87.7,0.0,0.1,0.2,1.1,36.5,0.6,98.7,0.0,0.0
BERMONDSEY AND OLD SOUTHWARK,75799,75545,17706,49144,1,8,324,8362,66850,49144,1,9,333,8695,35153,1014,67047,0,0,23.4,64.8,0.0,0.0,0.4,11.0,23.4,64.8,0.0,0.0,0.4,11.5,46.4,1.3,88.5,0.0,0.0
"BERWICKSHIRE, ROXBURGH AND SELKIRK",51173,50762,41038,2349,930,1425,1856,3164,43387,2349,930,2355,4211,7375,1846,4886,48520,8945,382,80.2,4.6,1.8,2.8,3.6,6.2,80.2,4.6,1.8,4.6,8.2,14.4,3.6,9.5,94.8,17.5,0.7
BERWICK-UPON-TWEED,38671,38592,31468,2319,574,758,861,2612,33787,2319,574,1332,2193,4805,2318,2398,36964,5338,90,81.4,6.0,1.5,2.0,2.2,6.8,81.4,6.0,1.5,3.4,5.7,12.4,6.0,6.2,95.6,13.8,0.2
BETHNAL GREEN AND BOW,65865,65362,20880,36305,0,0,257,7920,57185,36305,0,0,257,8177,12667,861,57204,0,0,31.7,55.1,0.0,0.0,0.4,12.0,31.7,55.1,0.0,0.0,0.4,12.4,19.2,1.3,86.9,0.0,0.0
BEVERLEY AND HOLDERNESS,48617,48200,20197,26028,219,242,365,1149,46225,26028,219,461,826,1975,26027,1375,47273,14043,11959,41.5,53.5,0.5,0.5,0.8,2.4,41.5,53.5,0.5,0.9,1.7,4.1,53.5,2.8,97.2,28.9,24.6
BEXHILL AND BATTLE,52145,52021,45903,2245,61,163,536,3113,48148,2245,61,224,760,3873,2245,896,51795,0,0,88.0,4.3,0.1,0.3,1.0,6.0,88.0,4.3,0.1,0.4,1.5,7.4,4.3,1.7,99.3,0.0,0.0
BEXLEYHEATH AND CRAYFORD,39169,39156,3261,34295,0,9,356,1235,37556,34295,0,9,365,1600,8284,902,37673,0,0,8.3,87.6,0.0,0.0,0.9,3.2,8.3,87.6,0.0,0.0,0.9,4.1,21.1,2.3,96.2,0.0,0.0
BIRKENHEAD,46522,46501,14256,31978,0,4,11,252,46234,31978,0,4,15,267,343,36,46407,0,0,30.6,68.7,0.0,0.0,0.0,0.5,30.6,68.7,0.0,0.0,0.0,0.6,0.7,0.1,99.8,0.0,0.0
"BIRMINGHAM, EDGBASTON",45364,45356,9917,32376,17,139,962,1945,42293,32376,17,156,1118,3063,912,1305,42306,0,0,21.9,71.4,0.0,0.3,2.1,4.3,21.9,71.4,0.0,0.3,2.5,6.8,2.0,2.9,93.3,0.0,0.0
"BIRMINGHAM, ERDINGTON",45419,45414,4154,39499,0,78,846,837,43653,39499,0,78,924,1761,5947,1243,43653,0,0,9.1,87.0,0.0,0.2,1.9,1.8,9.1,87.0,0.0,0.2,2.0,3.9,13.1,2.7,96.1,0.0,0.0
"BIRMINGHAM, HALL GREEN",43237,43222,4179,38043,0,8,44,948,42222,38043,0,8,52,1000,8315,150,42232,0,0,9.7,88.0,0.0,0.0,0.1,2.2,9.7,88.0,0.0,0.0,0.1,2.3,19.2,0.3,97.7,0.0,0.0
"BIRMINGHAM, HODGE HILL",42424,42418,11283,30852,0,54,123,106,42135,30852,0,54,177,283,8288,218,42140,0,0,26.6,72.7,0.0,0.1,0.3,0.2,26.6,72.7,0.0,0.1,0.4,0.7,19.5,0.5,99.3,0.0,0.0
"BIRMINGHAM, LADYWOOD",68164,67823,7364,49817,0,19,325,10298,57181,49817,0,19,344,10642,17167,971,57193,0,0,10.8,73.1,0.0,0.0,0.5,15.1,10.8,73.1,0.0,0.0,0.5,15.6,25.2,1.4,83.9,0.0,0.0
"BIRMINGHAM, NORTHFIELD",47515,47500,10870,35166,1,48,640,775,46036,35166,1,49,689,1464,4648,859,46105,0,0,22.9,74.0,0.0,0.1,1.3,1.6,22.9,74.0,0.0,0.1,1.5,3.1,9.8,1.8,97.0,0.0,0.0
"BIRMINGHAM, PERRY BARR",42997,42982,2429,39383,0,66,60,1044,41812,39383,0,66,126,1170,14167,221,41820,0,0,5.6,91.6,0.0,0.2,0.1,2.4,5.6,91.6,0.0,0.2,0.3,2.7,32.9,0.5,97.3,0.0,0.0
"BIRMINGHAM, SELLY OAK",44783,44775,5933,37428,0,16,295,1103,43361,37428,0,16,311,1414,7131,477,43383,0,0,13.2,83.6,0.0,0.0,0.7,2.5,13.2,83.6,0.0,0.0,0.7,3.2,15.9,1.1,96.9,0.0,0.0
"BIRMINGHAM, YARDLEY",45889,45880,2887,42373,6,18,287,309,45260,42373,6,24,311,620,21064,357,45266,0,0,6.3,92.3,0.0,0.0,0.6,0.7,6.3,92.3,0.0,0.1,0.7,1.4,45.9,0.8,98.6,0.0,0.0
BISHOP AUCKLAND,46488,46403,35205,6396,447,603,865,2887,41601,6396,447,1050,1915,4802,6396,2132,45078,633,78,75.7,13.8,1.0,1.3,1.9,6.2,75.7,13.8,1.0,2.3,4.1,10.3,13.8,4.6,97.0,1.4,0.2
BLACKBURN,47472,47437,14044,32639,20,71,36,627,46683,32639,20,91,127,754,677,170,47030,21373,7114,29.6,68.8,0.0,0.1,0.1,1.3,29.6,68.8,0.0,0.2,0.3,1.6,1.4,0.4,99.1,45.0,15.0
BLACKLEY AND BROUGHTON,53501,53488,22176,28719,151,55,789,1598,50895,28719,151,206,995,2593,2206,1300,51366,0,0,41.4,53.7,0.3,0.1,1.5,3.0,41.4,53.7,0.3,0.4,1.9,4.8,4.1,2.4,96.0,0.0,0.0
BLACKPOOL NORTH AND CLEVELEYS,43911,43890,21952,21541,0,8,13,376,43493,21541,0,8,21,397,41,44,43688,0,0,50.0,49.1,0.0,0.0,0.0,0.9,50.0,49.1,0.0,0.0,0.0,0.9,0.1,0.1,99.5,0.0,0.0
BLACKPOOL SOUTH,44610,44581,16159,27836,0,2,6,578,43995,27836,0,2,8,586,294,37,44049,0,0,36.2,62.4,0.0,0.0,0.0,1.3,36.2,62.4,0.0,0.0,0.0,1.3,0.7,0.1,98.7,0.0,0.0
BLAENAU GWENT,35203,35163,33651,460,15,46,209,782,34111,460,15,61,270,1052,460,311,34957,14,0,95.6,1.3,0.0,0.1,0.6,2.2,95.6,1.3,0.0,0.2,0.8,3.0,1.3,0.9,99.3,0.0,0.0
BLAYDON,43809,43727,21110,19380,47,161,725,2304,40490,19380,47,208,933,3237,2508,1213,42139,1,0,48.2,44.2,0.1,0.4,1.7,5.3,48.2,44.2,0.1,0.5,2.1,7.4,5.7,2.8,96.2,0.0,0.0
BLYTH VALLEY,40342,40328,35424,4289,0,22,18,575,39713,4289,0,22,40,615,768,54,40307,0,0,87.8,10.6,0.0,0.1,0.0,1.4,87.8,10.6,0.0,0.1,0.1,1.5,1.9,0.1,99.9,0.0,0.0
BOGNOR REGIS AND LITTLEHAMPTON,51677,51669,48612,1632,40,11,45,1329,50244,1632,40,51,96,1425,1632,152,51487,0,0,94.1,3.2,0.1,0.0,0.1,2.6,94.1,3.2,0.1,0.1,0.2,2.8,3.2,0.3,99.6,0.0,0.0
BOLSOVER,47504,47489,32599,10984,92,287,264,3263,43583,10984,92,379,643,3906,1920,788,46637,0,0,68.6,23.1,0.2,0.6,0.6,6.9,68.6,23.1,0.2,0.8,1.4,8.2,4.0,1.7,98.2,0.0,0.0
BOLTON NORTH EAST,47174,47121,13901,32803,0,34,113,270,46704,32803,0,34,147,417,530,200,46942,0,0,29.5,69.5,0.0,0.1,0.2,0.6,29.5,69.5,0.0,0.1,0.3,0.9,1.1,0.4,99.5,0.0,0.0
BOLTON SOUTH EAST,47906,47863,13859,33269,20,62,17,636,47128,33269,20,82,99,735,349,142,47361,136,0,28.9,69.4,0.0,0.1,0.0,1.3,28.9,69.4,0.0,0.2,0.2,1.5,0.7,0.3,98.9,0.3,0.0
BOLTON WEST,45578,45559,14192,30358,12,20,134,843,44550,30358,12,32,166,1009,359,290,45265,5834,3392,31.1,66.6,0.0,0.0,0.3,1.8,31.1,66.6,0.0,0.1,0.4,2.2,0.8,0.6,99.3,12.8,7.4
BOOTLE,49908,49906,7858,41640,0,59,65,284,49498,41640,0,59,124,408,1158,143,49549,0,0,15.7,83.4,0.0,0.1,0.1,0.6,15.7,83.4,0.0,0.1,0.2,0.8,2.3,0.3,99.3,0.0,0.0
BOSTON AND SKEGNESS,53035,52783,44024,2551,555,1089,1085,3479,46575,2551,555,1644,2729,6208,1184,2999,51380,3356,2752,83.0,4.8,1.0,2.1,2.0,6.6,83.0,4.8,1.0,3.1,5.1,11.7,2.2,5.7,96.9,6.3,5.2
BOSWORTH,51818,51387,19650,29489,49,470,380,1349,49139,29489,49,519,899,2248,3173,1386,50499,0,0,37.9,56.9,0.1,0.9,0.7,2.6,37.9,56.9,0.1,1.0,1.7,4.3,6.1,2.7,97.5,0.0,0.0
BOURNEMOUTH EAST,51554,51528,8100,42682,299,0,134,313,50782,42682,299,299,433,746,1280,461,51311,0,0,15.7,82.8,0.6,0.0,0.3,0.6,15.7,82.8,0.6,0.6,0.8,1.4,2.5,0.9,99.5,0.0,0.0
BOURNEMOUTH WEST,52524,52473,11311,40843,0,15,13,291,52154,40843,0,15,28,319,17954,83,52200,0,0,21.5,77.8,0.0,0.0,0.0,0.6,21.5,77.8,0.0,0.0,0.1,0.6,34.2,0.2,99.4,0.0,0.0
BRACKNELL,47879,47653,21601,23356,3,71,638,1984,44957,23356,3,74,712,2696,1691,1009,46563,0,0,45.1,48.8,0.0,0.1,1.3,4.1,45.1,48.8,0.0,0.2,1.5,5.6,3.5,2.1,97.3,0.0,0.0
BRADFORD EAST,43568,43555,9331,33153,0,37,45,989,42484,33153,0,37,82,1071,310,118,42649,24028,0,21.4,76.1,0.0,0.1,0.1,2.3,21.4,76.1,0.0,0.1,0.2,2.5,0.7,0.3,97.9,55.2,0.0
BRADFORD SOUTH,44146,44145,14748,28436,3,84,115,759,43184,28436,3,87,202,961,335,234,43614,3110,395,33.4,64.4,0.0,0.2,0.3,1.7,33.4,64.4,0.0,0.2,0.5,2.2,0.8,0.5,98.8,7.0,0.9
BRADFORD WEST,40434,40048,10338,28065,6,70,91,1478,38403,28065,6,76,167,1645,992,582,38629,13755,2213,25.6,69.4,0.0,0.2,0.2,3.7,25.6,69.4,0.0,0.2,0.4,4.1,2.5,1.4,95.5,34.0,5.5
BRAINTREE,47178,47118,39971,1106,519,1024,930,3568,41077,1106,519,1543,2473,6041,1076,2635,44704,0,0,84.7,2.3,1.1,2.2,2.0,7.6,84.7,2.3,1.1,3.3,5.2,12.8,2.3,5.6,94.8,0.0,0.0
BRECON AND RADNORSHIRE,36893,36365,23061,5129,1324,1283,1836,3732,28190,5129,1324,2607,4443,8175,5127,5139,32040,21,0,62.5,13.9,3.6,3.5,5.0,10.1,62.5,13.9,3.6,7.1,12.0,22.2,13.9,13.9,86.8,0.1,0.0
BRENT CENTRAL,62220,62144,35778,23943,5,22,458,1938,59721,23943,5,27,485,2423,9630,573,60007,0,0,57.5,38.5,0.0,0.0,0.7,3.1,57.5,38.5,0.0,0.0,0.8,3.9,15.5,0.9,96.4,0.0,0.0
BRENTFORD AND ISLEWORTH,55195,55107,7664,46432,0,24,74,913,54096,46432,0,24,98,1011,7530,209,54149,0,0,13.9,84.1,0.0,0.0,0.1,1.7,13.9,84.1,0.0,0.0,0.2,1.8,13.6,0.4,98.1,0.0,0.0
BRENT NORTH,48228,48086,11823,35474,0,50,58,681,47297,35474,0,50,108,789,7387,257,47325,0,0,24.5,73.6,0.0,0.1,0.1,1.4,24.5,73.6,0.0,0.1,0.2,1.6,15.3,0.5,98.1,0.0,0.0
BRENTWOOD AND ONGAR,45211,45183,33849,7869,74,93,258,3040,41718,7869,74,167,425,3465,3922,522,43711,0,0,74.9,17.4,0.2,0.2,0.6,6.7,74.9,17.4,0.2,0.4,0.9,7.7,8.7,1.2,96.7,0.0,0.0
BRIDGEND,38636,38622,28159,8568,12,22,321,1540,36727,8568,12,34,355,1895,5492,423,37963,15333,8788,72.9,22.2,0.0,0.1,0.8,4.0,72.9,22.2,0.0,0.1,0.9,4.9,14.2,1.1,98.3,39.7,22.7
BRIDGWATER AND WEST SOMERSET,56853,56754,45920,4733,706,880,1175,3340,50653,4733,706,1586,2761,6101,1831,3106,55065,2453,1065,80.8,8.3,1.2,1.5,2.1,5.9,80.8,8.3,1.2,2.8,4.9,10.7,3.2,5.5,96.9,4.3,1.9
BRIGG AND GOOLE,41755,41673,35914,2030,372,334,333,2690,37944,2030,372,706,1039,3729,777,1141,40334,20831,18706,86.0,4.9,0.9,0.8,0.8,6.4,86.0,4.9,0.9,1.7,2.5,8.9,1.9,2.7,96.6,49.9,44.8
"BRIGHTON, KEMPTOWN",46164,46053,14219,30867,0,3,41,923,45086,30867,0,3,44,967,5957,172,45508,0,0,30.8,66.9,0.0,0.0,0.1,2.0,30.8,66.9,0.0,0.0,0.1,2.1,12.9,0.4,98.6,0.0,0.0
"BRIGHTON, PAVILION",56911,56877,11707,43593,4,56,521,996,55300,43593,4,60,581,1577,483,878,55391,0,0,20.6,76.6,0.0,0.1,0.9,1.8,20.6,76.6,0.0,0.1,1.0,2.8,0.8,1.5,97.3,0.0,0.0
BRISTOL EAST,46559,46528,4144,40961,4,35,213,1171,45105,40961,4,39,252,1423,13600,430,45162,0,0,8.9,88.0,0.0,0.1,0.5,2.5,8.9,88.0,0.0,0.1,0.5,3.1,29.2,0.9,97.0,0.0,0.0
BRISTOL NORTH WEST,46280,46250,7285,37492,3,47,307,1116,44777,37492,3,50,357,1473,3063,420,44918,0,0,15.7,81.0,0.0,0.1,0.7,2.4,15.7,81.0,0.0,0.1,0.8,3.2,6.6,0.9,97.1,0.0,0.0
BRISTOL SOUTH,51942,51902,3182,47272,0,11,189,1248,50454,47272,0,11,200,1448,25980,313,50467,0,0,6.1,91.0,0.0,0.0,0.4,2.4,6.1,91.0,0.0,0.0,0.4,2.8,50.0,0.6,97.2,0.0,0.0
BRISTOL WEST,68962,68826,8431,54885,0,0,187,5323,63316,54885,0,0,187,5510,27682,590,63318,0,0,12.2,79.6,0.0,0.0,0.3,7.7,12.2,79.6,0.0,0.0,0.3,8.0,40.1,0.9,91.8,0.0,0.0
BROADLAND,47947,47834,38204,4149,392,823,1030,3236,42353,4149,392,1215,2245,5481,3255,2411,46493,61,61,79.7,8.7,0.8,1.7,2.1,6.7,79.7,8.7,0.8,2.5,4.7,11.4,6.8,5.0,97.0,0.1,0.1
BROMLEY AND CHISLEHURST,42030,42023,6393,34601,1,2,75,951,40994,34601,1,3,78,1029,250,92,41399,0,0,15.2,82.3,0.0,0.0,0.2,2.3,15.2,82.3,0.0,0.0,0.2,2.4,0.6,0.2,98.5,0.0,0.0
BROMSGROVE,44955,44917,29800,12434,156,288,288,1951,42234,12434,156,444,732,2683,3300,772,44527,719,13,66.3,27.7,0.3,0.6,0.6,4.3,66.3,27.7,0.3,1.0,1.6,6.0,7.3,1.7,99.0,1.6,0.0
BROXBOURNE,45229,45219,6491,37913,28,23,87,677,44404,37913,28,51,138,815,451,150,44911,0,0,14.4,83.8,0.1,0.1,0.2,1.5,14.4,83.8,0.1,0.1,0.3,1.8,1.0,0.3,99.3,0.0,0.0
BROXTOWE,45029,45021,4337,40259,15,46,31,333,44596,40259,15,61,92,425,290,103,44851,0,0,9.6,89.4,0.0,0.1,0.1,0.7,9.6,89.4,0.0,0.1,0.2,0.9,0.6,0.2,99.6,0.0,0.0
BUCKINGHAM,48683,48656,34503,7832,446,924,1063,3888,42335,7832,446,1370,2433,6321,6587,2591,45778,0,0,70.9,16.1,0.9,1.9,2.2,8.0,70.9,16.1,0.9,2.8,5.0,13.0,13.5,5.3,94.0,0.0,0.0
BURNLEY,45164,45111,15370,28917,37,11,91,685,44287,28917,37,48,139,824,285,192,44917,20522,5085,34.0,64.0,0.1,0.0,0.2,1.5,34.0,64.0,0.1,0.1,0.3,1.8,0.6,0.4,99.5,45.4,11.3
BURTON,49821,49761,34457,12720,87,182,334,1981,47177,12720,87,269,603,2584,10362,688,49280,0,0,69.2,25.5,0.2,0.4,0.7,4.0,69.2,25.5,0.2,0.5,1.2,5.2,20.8,1.4,98.9,0.0,0.0
BURY NORTH,42036,41895,24528,16202,11,59,45,1050,40730,16202,11,70,115,1165,3109,256,41857,99,0,58.3,38.5,0.0,0.1,0.1,2.5,58.3,38.5,0.0,0.2,0.3,2.8,7.4,0.6,99.6,0.2,0.0
BURY SOUTH,45452,45294,20304,23805,2,21,46,1116,44109,23805,2,23,69,1185,5237,227,45206,0,0,44.7,52.4,0.0,0.0,0.1,2.5,44.7,52.4,0.0,0.1,0.2,2.6,11.5,0.5,99.5,0.0,0.0
BURY ST EDMUNDS,56164,56139,47709,4595,133,169,304,3229,52304,4595,133,302,606,3835,2214,658,55408,0,0,84.9,8.2,0.2,0.3,0.5,5.7,84.9,8.2,0.2,0.5,1.1,6.8,3.9,1.2,98.7,0.0,0.0
CAERPHILLY,39906,39904,35158,3578,17,41,77,1033,38736,3578,17,58,135,1168,264,137,39843,20777,16546,88.1,9.0,0.0,0.1,0.2,2.6,88.1,9.0,0.0,0.1,0.3,2.9,0.7,0.3,99.8,52.1,41.5
"CAITHNESS, SUTHERLAND AND EASTER ROSS",29206,28801,22107,165,720,920,1414,3475,22272,165,720,1640,3054,6529,165,3523,27023,3943,548,75.7,0.6,2.5,3.2,4.8,11.9,75.7,0.6,2.5,5.6,10.5,22.4,0.6,12.1,92.5,13.5,1.9
CALDER VALLEY,52657,52647,31723,15853,114,255,425,4277,47576,15853,114,369,794,5071,3099,844,51710,10,10,60.2,30.1,0.2,0.5,0.8,8.1,60.2,30.1,0.2,0.7,1.5,9.6,5.9,1.6,98.2,0.0,0.0
CAMBERWELL AND PECKHAM,56977,56940,14148,39576,0,0,75,3141,53724,39576,0,0,75,3216,11807,159,53741,0,0,24.8,69.5,0.0,0.0,0.1,5.5,24.8,69.5,0.0,0.0,0.1,5.6,20.7,0.3,94.3,0.0,0.0
CAMBORNE AND REDRUTH,45823,45724,22569,18836,112,387,572,3248,41405,18836,112,499,1071,4319,18836,1439,44208,0,0,49.3,41.1,0.2,0.8,1.2,7.1,49.3,41.1,0.2,1.1,2.3,9.4,41.1,3.1,96.5,0.0,0.0
CAMBRIDGE,56233,56161,7234,47958,0,19,177,773,55192,47958,0,19,196,969,3482,349,55273,268,0,12.9,85.3,0.0,0.0,0.3,1.4,12.9,85.3,0.0,0.0,0.3,1.7,6.2,0.6,98.3,0.5,0.0
CANNOCK CHASE,47009,46997,35123,10463,9,23,8,1371,45586,10463,9,32,40,1411,313,269,46644,0,0,74.7,22.3,0.0,0.0,0.0,2.9,74.7,22.3,0.0,0.1,0.1,3.0,0.7,0.6,99.2,0.0,0.0
CANTERBURY,54225,54054,48484,1364,210,284,430,3282,49848,1364,210,494,924,4206,1364,1099,53745,0,0,89.4,2.5,0.4,0.5,0.8,6.1,89.4,2.5,0.4,0.9,1.7,7.8,2.5,2.0,99.1,0.0,0.0
CARDIFF CENTRAL,42118,41608,9340,29719,2,30,147,2370,39059,29719,2,32,179,2549,7080,790,39166,19282,5836,22.2,70.6,0.0,0.1,0.3,5.6,22.2,70.6,0.0,0.1,0.4,6.1,16.8,1.9,93.0,45.8,13.9
CARDIFF NORTH,39467,39463,6645,32076,17,33,180,512,38721,32076,17,50,230,742,23324,236,39286,21002,3785,16.8,81.3,0.0,0.1,0.5,1.3,16.8,81.3,0.0,0.1,0.6,1.9,59.1,0.6,99.5,53.2,9.6
CARDIFF SOUTH AND PENARTH,55657,55619,12146,42139,6,288,369,671,54285,42139,6,294,663,1334,10885,1003,54426,27123,14853,21.8,75.7,0.0,0.5,0.7,1.2,21.8,75.7,0.0,0.5,1.2,2.4,19.6,1.8,97.8,48.7,26.7
CARDIFF WEST,43679,43666,7503,35636,4,13,9,501,43139,35636,4,17,26,527,8078,44,43578,27935,22231,17.2,81.6,0.0,0.0,0.0,1.1,17.2,81.6,0.0,0.0,0.1,1.2,18.5,0.1,99.8,64.0,50.9
CARLISLE,45263,45228,19772,23986,79,237,264,890,43758,23986,79,316,580,1470,1148,803,44421,0,0,43.7,53.0,0.2,0.5,0.6,2.0,43.7,53.0,0.2,0.7,1.3,3.2,2.5,1.8,98.1,0.0,0.0
CARMARTHEN EAST AND DINEFWR,35778,35488,23652,4674,1044,1377,1378,3363,28326,4674,1044,2421,3799,7162,4674,4281,32074,6794,4817,66.1,13.1,2.9,3.8,3.9,9.4,66.1,13.1,2.9,6.8,10.6,20.0,13.1,12.0,89.6,19.0,13.5
CARMARTHEN WEST AND SOUTH PEMBROKESHIRE,41471,41431,34199,2227,637,862,889,2617,36426,2227,637,1499,2388,5005,2222,2581,39617,1496,69,82.5,5.4,1.5,2.1,2.1,6.3,82.5,5.4,1.5,3.6,5.8,12.1,5.4,6.2,95.5,3.6,0.2
CARSHALTON AND WALLINGTON,42457,42424,6522,35125,13,4,158,602,41647,35125,13,17,175,777,814,326,41856,0,0,15.4,82.7,0.0,0.0,0.4,1.4,15.4,82.7,0.0,0.0,0.4,1.8,1.9,0.8,98.6,0.0,0.0
CASTLE POINT,40841,40747,22378,17926,7,58,25,353,40304,17926,7,65,90,443,1168,184,40667,0,0,54.8,43.9,0.0,0.1,0.1,0.9,54.8,43.9,0.0,0.2,0.2,1.1,2.9,0.5,99.6,0.0,0.0
CENTRAL AYRSHIRE,44701,44692,14306,28294,109,190,520,1273,42600,28294,109,299,819,2092,618,869,44250,0,0,32.0,63.3,0.2,0.4,1.2,2.8,32.0,63.3,0.2,0.7,1.8,4.7,1.4,1.9,99.0,0.0,0.0
CENTRAL DEVON,45090,44985,33004,1666,850,1600,2396,5469,34670,1666,850,2450,4846,10315,1351,5170,41592,15402,8334,73.2,3.7,1.9,3.5,5.3,12.1,73.2,3.7,1.9,5.4,10.7,22.9,3.0,11.5,92.2,34.2,18.5
CENTRAL SUFFOLK AND NORTH IPSWICH,46810,46776,27227,14670,321,540,939,3079,41897,14670,321,861,1800,4879,3360,1889,45621,0,0,58.2,31.3,0.7,1.2,2.0,6.6,58.2,31.3,0.7,1.8,3.8,10.4,7.2,4.0,97.5,0.0,0.0
CEREDIGION,37454,37282,22757,7504,1035,1389,1677,2920,30261,7504,1035,2424,4101,7021,7504,4542,33880,1231,986,60.8,20.0,2.8,3.7,4.5,7.8,60.8,20.0,2.8,6.5,10.9,18.7,20.0,12.1,90.5,3.3,2.6
CHARNWOOD,45033,45020,11659,32386,13,46,228,688,44045,32386,13,59,287,975,5643,303,44647,0,0,25.9,71.9,0.0,0.1,0.5,1.5,25.9,71.9,0.0,0.1,0.6,2.2,12.5,0.7,99.1,0.0,0.0
CHATHAM AND AYLESFORD,43456,43442,7565,35217,10,32,161,457,42782,35217,10,42,203,660,540,239,43146,0,0,17.4,81.0,0.0,0.1,0.4,1.1,17.4,81.0,0.0,0.1,0.5,1.5,1.2,0.5,99.3,0.0,0.0
CHEADLE,42529,42490,10789,30992,0,4,7,698,41781,30992,0,4,11,709,491,54,42213,5386,0,25.4,72.9,0.0,0.0,0.0,1.6,25.4,72.9,0.0,0.0,0.0,1.7,1.2,0.1,99.3,12.7,0.0
CHELMSFORD,51671,51663,17396,33017,31,13,18,1188,50413,33017,31,44,62,1250,1823,91,50932,0,0,33.7,63.9,0.1,0.0,0.0,2.3,33.7,63.9,0.1,0.1,0.1,2.4,3.5,0.2,98.6,0.0,0.0
CHELSEA AND FULHAM,60925,60819,22639,34390,0,0,7,3783,57029,34390,0,0,7,3790,8291,118,57030,0,0,37.2,56.4,0.0,0.0,0.0,6.2,37.2,56.4,0.0,0.0,0.0,6.2,13.6,0.2,93.6,0.0,0.0
CHELTENHAM,54233,54216,14901,38087,26,104,204,894,52988,38087,26,130,334,1228,2592,384,53550,0,0,27.5,70.2,0.0,0.2,0.4,1.6,27.5,70.2,0.0,0.2,0.6,2.3,4.8,0.7,98.7,0.0,0.0
CHESHAM AND AMERSHAM,42619,42614,20826,18499,27,93,198,2971,39325,18499,27,120,318,3289,301,345,42422,0,0,48.9,43.4,0.1,0.2,0.5,7.0,48.9,43.4,0.1,0.3,0.7,7.7,0.7,0.8,99.5,0.0,0.0
CHESTERFIELD,47860,47840,29133,17296,10,12,92,1297,46429,17296,10,22,114,1411,1488,137,47581,0,0,60.9,36.1,0.0,0.0,0.2,2.7,60.9,36.1,0.0,0.0,0.2,2.9,3.1,0.3,99.4,0.0,0.0
CHICHESTER,56918,56778,40648,11536,304,293,542,3455,52184,11536,304,597,1139,4594,10773,1299,56239,0,0,71.4,20.3,0.5,0.5,1.0,6.1,71.4,20.3,0.5,1.0,2.0,8.1,18.9,2.3,98.8,0.0,0.0
CHINGFORD AND WOODFORD GREEN,39516,39513,5771,32643,6,1,171,921,38414,32643,6,7,178,1099,4408,382,38504,0,0,14.6,82.6,0.0,0.0,0.4,2.3,14.6,82.6,0.0,0.0,0.5,2.8,11.2,1.0,97.4,0.0,0.0
CHIPPENHAM,46701,46683,32652,11515,48,89,161,2218,44167,11515,48,137,298,2516,1549,361,45978,0,0,69.9,24.7,0.1,0.2,0.3,4.7,69.9,24.7,0.1,0.3,0.6,5.4,3.3,0.8,98.5,0.0,0.0
CHIPPING BARNET,48744,48742,23697,23406,0,4,104,1531,47103,23406,0,4,108,1639,17243,186,47733,0,0,48.6,48.0,0.0,0.0,0.2,3.1,48.6,48.0,0.0,0.0,0.2,3.4,35.4,0.4,97.9,0.0,0.0
CHORLEY,48933,48906,20786,25604,34,412,379,1691,46390,25604,34,446,825,2516,2018,857,48075,20992,10970,42.5,52.3,0.1,0.8,0.8,3.5,42.5,52.3,0.1,0.9,1.7,5.1,4.1,1.8,98.2,42.9,22.4
CHRISTCHURCH,43868,43846,22861,18649,59,60,82,2135,41510,18649,59,119,201,2336,5935,223,43696,0,0,52.1,42.5,0.1,0.1,0.2,4.9,52.1,42.5,0.1,0.3,0.5,5.3,13.5,0.5,99.6,0.0,0.0
CITIES OF LONDON AND WESTMINSTER,111073,110924,33585,49553,0,0,48,27738,83138,49553,0,0,48,27786,43714,301,83148,0,0,30.2,44.6,0.0,0.0,0.0,25.0,30.2,44.6,0.0,0.0,0.0,25.0,39.4,0.3,74.9,0.0,0.0
CITY OF CHESTER,49078,49039,37089,9913,49,46,192,1750,47002,9913,49,95,287,2037,4344,328,48485,3860,0,75.6,20.2,0.1,0.1,0.4,3.6,75.6,20.2,0.1,0.2,0.6,4.2,8.9,0.7,98.8,7.9,0.0
CITY OF DURHAM,44701,44690,41350,758,39,48,67,2428,42108,758,39,87,154,2582,684,319,44003,0,0,92.5,1.7,0.1,0.1,0.1,5.4,92.5,1.7,0.1,0.2,0.3,5.8,1.5,0.7,98.4,0.0,0.0
CLACTON,46888,46869,43592,1253,113,328,145,1438,44845,1253,113,441,586,2024,1253,666,46522,0,0,93.0,2.7,0.2,0.7,0.3,3.1,93.0,2.7,0.2,0.9,1.2,4.3,2.7,1.4,99.2,0.0,0.0
CLEETHORPES,44358,44322,12892,28868,140,584,366,1472,41760,28868,140,724,1090,2562,598,1271,42915,12493,8305,29.1,65.1,0.3,1.3,0.8,3.3,29.1,65.1,0.3,1.6,2.5,5.8,1.3,2.9,96.7,28.2,18.7
CLWYD SOUTH,34612,34489,27525,3629,333,408,693,1901,31154,3629,333,741,1434,3335,3282,1676,33364,11800,5063,79.5,10.5,1.0,1.2,2.0,5.5,79.5,10.5,1.0,2.1,4.1,9.6,9.5,4.8,96.4,34.1,14.6
CLWYD WEST,36632,36562,30986,1629,449,648,863,1987,32615,1629,449,1097,1960,3947,1629,2146,34998,17059,9776,84.6,4.4,1.2,1.8,2.4,5.4,84.6,4.4,1.2,3.0,5.4,10.8,4.4,5.9,95.5,46.6,26.7
"COATBRIDGE, CHRYSTON AND BELLSHILL",45639,45627,7706,36960,53,338,102,468,44666,36960,53,391,493,961,7370,506,44847,0,0,16.9,81.0,0.1,0.7,0.2,1.0,16.9,81.0,0.1,0.9,1.1,2.1,16.1,1.1,98.3,0.0,0.0
COLCHESTER,56285,56137,18441,36755,0,37,120,784,55196,36755,0,37,157,941,2413,355,55431,0,0,32.8,65.3,0.0,0.1,0.2,1.4,32.8,65.3,0.0,0.1,0.3,1.7,4.3,0.6,98.5,0.0,0.0
COLNE VALLEY,52496,52483,22793,26794,69,282,621,1924,49587,26794,69,351,972,2896,1944,1020,51482,0,0,43.4,51.0,0.1,0.5,1.2,3.7,43.4,51.0,0.1,0.7,1.9,5.5,3.7,1.9,98.1,0.0,0.0
CONGLETON,49044,49024,40407,4094,124,141,314,3944,44501,4094,124,265,579,4523,1459,616,48364,0,0,82.4,8.3,0.3,0.3,0.6,8.0,82.4,8.3,0.3,0.5,1.2,9.2,3.0,1.3,98.6,0.0,0.0
COPELAND,41907,41833,38528,586,206,314,416,1783,39114,586,206,520,936,2719,586,1014,41462,1126,1076,91.9,1.4,0.5,0.7,1.0,4.3,91.9,1.4,0.5,1.2,2.2,6.5,1.4,2.4,98.9,2.7,2.6
CORBY,56341,56252,25166,29684,87,216,127,972,54850,29684,87,303,430,1402,8407,533,55594,0,0,44.7,52.7,0.2,0.4,0.2,1.7,44.7,52.7,0.2,0.5,0.8,2.5,14.9,0.9,98.7,0.0,0.0
COVENTRY NORTH EAST,52121,52115,5939,44942,2,228,216,788,50881,44942,2,230,446,1234,8587,685,51043,0,0,11.4,86.2,0.0,0.4,0.4,1.5,11.4,86.2,0.0,0.4,0.9,2.4,16.5,1.3,97.9,0.0,0.0
COVENTRY NORTH WEST,47209,47206,5398,40505,8,140,317,838,45903,40505,8,148,465,1303,23858,507,46134,0,0,11.4,85.8,0.0,0.3,0.7,1.8,11.4,85.8,0.0,0.3,1.0,2.8,50.5,1.1,97.7,0.0,0.0
COVENTRY SOUTH,49234,48889,15324,29975,0,351,328,2911,45299,29975,0,351,679,3590,18733,1269,45717,0,0,31.1,60.9,0.0,0.7,0.7,5.9,31.1,60.9,0.0,0.7,1.4,7.3,38.0,2.6,92.9,0.0,0.0
CRAWLEY,48273,48262,7141,40666,4,22,55,374,47807,40666,4,26,81,455,936,93,48159,0,0,14.8,84.2,0.0,0.0,0.1,0.8,14.8,84.2,0.0,0.1,0.2,0.9,1.9,0.2,99.8,0.0,0.0
CREWE AND NANTWICH,54119,54091,45093,6170,20,188,401,2219,51263,6170,20,208,609,2828,1200,643,53124,2184,0,83.3,11.4,0.0,0.3,0.7,4.1,83.3,11.4,0.0,0.4,1.1,5.2,2.2,1.2,98.2,4.0,0.0
CROYDON CENTRAL,55260,55238,13356,39858,1,2,43,1978,53214,39858,1,3,46,2024,3551,192,53561,0,0,24.2,72.1,0.0,0.0,0.1,3.6,24.2,72.1,0.0,0.0,0.1,3.7,6.4,0.3,96.9,0.0,0.0
CROYDON NORTH,61446,61416,14370,44176,0,6,249,2615,58546,44176,0,6,255,2870,20643,461,58630,0,0,23.4,71.9,0.0,0.0,0.4,4.3,23.4,71.9,0.0,0.0,0.4,4.7,33.6,0.8,95.4,0.0,0.0
CROYDON SOUTH,50024,50014,12338,35490,0,54,155,1977,47828,35490,0,54,209,2186,885,343,48491,0,0,24.7,70.9,0.0,0.1,0.3,4.0,24.7,70.9,0.0,0.1,0.4,4.4,1.8,0.7,96.9,0.0,0.0
"CUMBERNAULD, KILSYTH AND KIRKINTILLOCH EAST",42205,42199,15437,24899,55,99,219,1490,40336,24899,55,154,373,1863,3423,396,41727,0,0,36.6,59.0,0.1,0.2,0.5,3.5,36.6,59.0,0.1,0.4,0.9,4.4,8.1,0.9,98.9,0.0,0.0
CYNON VALLEY,35540,35456,33166,1156,22,20,161,931,34322,1156,22,42,203,1134,641,363,35170,5537,1144,93.3,3.3,0.1,0.1,0.5,2.6,93.3,3.3,0.1,0.1,0.6,3.2,1.8,1.0,99.0,15.6,3.2
DAGENHAM AND RAINHAM,45957,45291,4572,39449,18,142,190,920,44021,39449,18,160,350,1270,14439,1055,44189,0,0,9.9,85.8,0.0,0.3,0.4,2.0,9.9,85.8,0.0,0.3,0.8,2.8,31.4,2.3,96.2,0.0,0.0
DARLINGTON,47134,47113,3769,42302,49,481,172,340,46071,42302,49,530,702,1042,349,734,46160,8098,1504,8.0,89.7,0.1,1.0,0.4,0.7,8.0,89.7,0.1,1.1,1.5,2.2,0.7,1.6,97.9,17.2,3.2
DARTFORD,51257,51243,24833,23635,131,201,459,1984,48468,23635,131,332,791,2775,5408,982,50103,0,0,48.4,46.1,0.3,0.4,0.9,3.9,48.4,46.1,0.3,0.6,1.5,5.4,10.6,1.9,97.7,0.0,0.0
DAVENTRY,45754,45730,30425,12079,192,411,518,2105,42504,12079,192,603,1121,3226,8085,1238,44684,311,311,66.5,26.4,0.4,0.9,1.1,4.6,66.5,26.4,0.4,1.3,2.5,7.1,17.7,2.7,97.7,0.7,0.7
DELYN,33929,33886,26810,4489,123,308,553,1603,31299,4489,123,431,984,2587,3532,1058,33041,11923,5897,79.0,13.2,0.4,0.9,1.6,4.7,79.0,13.2,0.4,1.3,2.9,7.6,10.4,3.1,97.4,35.1,17.4
DENTON AND REDDISH,43824,43773,11281,31739,0,36,44,673,43020,31739,0,36,80,753,266,134,43533,0,0,25.7,72.4,0.0,0.1,0.1,1.5,25.7,72.4,0.0,0.1,0.2,1.7,0.6,0.3,99.3,0.0,0.0
DERBY NORTH,47742,47730,5583,41790,0,0,84,273,47373,41790,0,0,84,357,1351,98,47573,0,0,11.7,87.5,0.0,0.0,0.2,0.6,11.7,87.5,0.0,0.0,0.2,0.7,2.8,0.2,99.6,0.0,0.0
DERBYSHIRE DALES,41366,41288,31968,2810,278,1029,1564,3639,34778,2810,278,1307,2871,6510,2430,3142,38828,0,0,77.3,6.8,0.7,2.5,3.8,8.8,77.3,6.8,0.7,3.2,6.9,15.7,5.9,7.6,93.9,0.0,0.0
DERBY SOUTH,52410,52365,5110,46720,0,14,19,502,51830,46720,0,14,33,535,3725,92,51974,0,0,9.8,89.1,0.0,0.0,0.0,1.0,9.8,89.1,0.0,0.0,0.1,1.0,7.1,0.2,99.2,0.0,0.0
DEVIZES,44845,44822,30809,10194,71,257,595,2896,41003,10194,71,328,923,3819,2203,988,43822,0,0,68.7,22.7,0.2,0.6,1.3,6.5,68.7,22.7,0.2,0.7,2.1,8.5,4.9,2.2,97.7,0.0,0.0
DEWSBURY,48325,48320,21186,25176,11,85,166,1696,46362,25176,11,96,262,1958,1392,300,47498,0,0,43.8,52.1,0.0,0.2,0.3,3.5,43.8,52.1,0.0,0.2,0.5,4.1,2.9,0.6,98.3,0.0,0.0
DONCASTER CENTRAL,52149,52131,24308,26521,3,60,113,1126,50829,26521,3,63,176,1302,586,208,51356,10355,10330,46.6,50.9,0.0,0.1,0.2,2.2,46.6,50.9,0.0,0.1,0.3,2.5,1.1,0.4,98.5,19.9,19.8
DONCASTER NORTH,46808,46801,20129,24692,91,241,205,1443,44821,24692,91,332,537,1980,8705,628,46319,3944,3244,43.0,52.8,0.2,0.5,0.4,3.1,43.0,52.8,0.2,0.7,1.1,4.2,18.6,1.3,99.0,8.4,6.9
DON VALLEY,46625,46609,34975,9647,33,155,199,1600,44622,9647,33,188,387,1987,1746,437,46053,7089,6738,75.0,20.7,0.1,0.3,0.4,3.4,75.0,20.7,0.1,0.4,0.8,4.3,3.7,0.9,98.8,15.2,14.5
DOVER,48244,48217,29716,15630,244,181,236,2210,45346,15630,244,425,661,2871,971,766,47575,0,0,61.6,32.4,0.5,0.4,0.5,4.6,61.6,32.4,0.5,0.9,1.4,6.0,2.0,1.6,98.6,0.0,0.0
DUDLEY NORTH,37889,37859,9549,28002,0,0,11,297,37551,28002,0,0,11,308,110,48,37661,307,0,25.2,73.9,0.0,0.0,0.0,0.8,25.2,73.9,0.0,0.0,0.0,0.8,0.3,0.1,99.4,0.8,0.0
DUDLEY SOUTH,38332,38309,8211,29771,0,8,33,286,37982,29771,0,8,41,327,198,164,38019,78,0,21.4,77.7,0.0,0.0,0.1,0.7,21.4,77.7,0.0,0.0,0.1,0.9,0.5,0.4,99.2,0.2,0.0
DULWICH AND WEST NORWOOD,52253,52200,12528,38190,0,0,0,1482,50718,38190,0,0,0,1482,1287,66,50761,0,0,24.0,73.1,0.0,0.0,0.0,2.8,24.0,73.1,0.0,0.0,0.0,2.8,2.5,0.1,97.1,0.0,0.0
DUMFRIES AND GALLOWAY,53490,53178,43318,2087,1013,1443,1658,3659,45405,2087,1013,2456,4114,7773,2087,4517,51196,0,0,81.0,3.9,1.9,2.7,3.1,6.8,81.0,3.9,1.9,4.6,7.7,14.5,3.9,8.4,95.7,0.0,0.0
"DUMFRIESSHIRE, CLYDESDALE AND TWEEDDALE",44884,44595,34390,2009,931,1345,1925,3995,36399,2009,931,2276,4201,8196,2009,4594,42386,0,0,76.6,4.5,2.1,3.0,4.3,8.9,76.6,4.5,2.1,5.1,9.4,18.3,4.5,10.2,94.4,0.0,0.0
DUNDEE EAST,43932,43920,8014,34149,70,137,377,1173,42163,34149,70,207,584,1757,291,651,43266,0,0,18.2,77.7,0.2,0.3,0.9,2.7,18.2,77.7,0.2,0.5,1.3,4.0,0.7,1.5,98.5,0.0,0.0
DUNDEE WEST,49466,49444,7699,40613,69,54,235,774,48312,40613,69,123,358,1132,462,404,48864,0,0,15.6,82.1,0.1,0.1,0.5,1.6,15.6,82.1,0.1,0.2,0.7,2.3,0.9,0.8,98.8,0.0,0.0
DUNFERMLINE AND WEST FIFE,50429,50383,24536,23980,131,281,225,1230,48516,23980,131,412,637,1867,23923,683,50215,0,0,48.7,47.6,0.3,0.6,0.4,2.4,48.7,47.6,0.3,0.8,1.3,3.7,47.4,1.4,99.6,0.0,0.0
DWYFOR MEIRIONNYDD,38332,38178,25844,6325,793,1055,1264,2897,32169,6325,793,1848,3112,6009,6325,3372,35609,4,0,67.4,16.5,2.1,2.8,3.3,7.6,67.4,16.5,2.1,4.8,8.1,15.7,16.5,8.8,92.9,0.0,0.0
EALING CENTRAL AND ACTON,60893,60866,11494,48150,0,42,168,1012,59644,48150,0,42,210,1222,8177,400,59654,0,0,18.9,79.1,0.0,0.1,0.3,1.7,18.9,79.1,0.0,0.1,0.3,2.0,13.4,0.7,98.0,0.0,0.0
EALING NORTH,48459,48435,13113,34866,0,4,269,183,47979,34866,0,4,273,456,3486,334,48029,0,0,27.1,71.9,0.0,0.0,0.6,0.4,27.1,71.9,0.0,0.0,0.6,0.9,7.2,0.7,99.1,0.0,0.0
"EALING, SOUTHALL",37664,37635,21127,15786,0,1,48,673,36913,15786,0,1,49,722,4802,206,36937,0,0,56.1,41.9,0.0,0.0,0.1,1.8,56.1,41.9,0.0,0.0,0.1,1.9,12.7,0.5,98.1,0.0,0.0
EASINGTON,41063,41053,35107,4321,30,50,101,1444,39428,4321,30,80,181,1625,181,191,40993,0,0,85.5,10.5,0.1,0.1,0.2,3.5,85.5,10.5,0.1,0.2,0.4,4.0,0.4,0.5,99.8,0.0,0.0
EAST ANTRIM,41211,40838,18714,19173,658,367,332,1594,37887,19173,658,1025,1357,2951,16607,1744,40449,0,0,45.4,46.5,1.6,0.9,0.8,3.9,45.4,46.5,1.6,2.5,3.3,7.2,40.3,4.2,98.2,0.0,0.0
EASTBOURNE,54270,54260,53070,504,0,6,48,632,53574,504,0,6,54,686,504,64,53995,0,0,97.8,0.9,0.0,0.0,0.1,1.2,97.8,0.9,0.0,0.0,0.1,1.3,0.9,0.1,99.5,0.0,0.0
EAST DEVON,53363,53317,38983,8782,169,704,876,3803,47765,8782,169,873,1749,5552,3033,1999,51153,17997,1466,73.1,16.5,0.3,1.3,1.6,7.1,73.1,16.5,0.3,1.6,3.3,10.4,5.7,3.7,95.9,33.7,2.7
EAST DUNBARTONSHIRE,37282,37266,5332,30795,9,23,103,1004,36127,30795,9,32,135,1139,1055,170,36585,0,0,14.3,82.6,0.0,0.1,0.3,2.7,14.3,82.6,0.0,0.1,0.4,3.1,2.8,0.5,98.1,0.0,0.0
EAST HAM,54476,54459,13306,39874,3,60,633,583,53180,39874,3,63,696,1279,9800,840,53191,0,0,24.4,73.2,0.0,0.1,1.2,1.1,24.4,73.2,0.0,0.1,1.3,2.3,18.0,1.5,97.6,0.0,0.0
EAST HAMPSHIRE,47257,47043,31173,11025,164,309,584,3788,42198,11025,164,473,1057,4845,2617,1415,45548,0,0,66.0,23.3,0.3,0.7,1.2,8.0,66.0,23.3,0.3,1.0,2.2,10.3,5.5,3.0,96.4,0.0,0.0
"EAST KILBRIDE, STRATHAVEN AND LESMAHAGOW",49503,49475,17443,29898,211,320,649,954,47341,29898,211,531,1180,2134,1108,1234,48600,0,0,35.2,60.4,0.4,0.6,1.3,1.9,35.2,60.4,0.4,1.1,2.4,4.3,2.2,2.5,98.2,0.0,0.0
EASTLEIGH,50063,50024,20735,27295,0,28,84,1882,48030,27295,0,28,112,1994,3117,167,49266,0,0,41.4,54.5,0.0,0.1,0.2,3.8,41.4,54.5,0.0,0.1,0.2,4.0,6.2,0.3,98.4,0.0,0.0
EAST LONDONDERRY,46881,45953,31208,8856,1105,914,793,3077,40064,8856,1105,2019,2812,5889,8851,3758,45624,0,0,66.6,18.9,2.4,1.9,1.7,6.6,66.6,18.9,2.4,4.3,6.0,12.6,18.9,8.0,97.3,0.0,0.0
EAST LOTHIAN,48580,48529,40583,3987,203,518,504,2734,44570,3987,203,721,1225,3959,3988,1364,47370,13201,12972,83.5,8.2,0.4,1.1,1.0,5.6,83.5,8.2,0.4,1.5,2.5,8.1,8.2,2.8,97.5,27.2,26.7
EAST RENFREWSHIRE,40711,40704,11065,27759,94,62,134,1590,38824,27759,94,156,290,1880,689,401,40081,0,0,27.2,68.2,0.2,0.2,0.3,3.9,27.2,68.2,0.2,0.4,0.7,4.6,1.7,1.0,98.5,0.0,0.0
EAST SURREY,49571,49552,21785,25087,46,156,205,2273,46872,25087,46,202,407,2680,3276,463,49314,0,0,43.9,50.6,0.1,0.3,0.4,4.6,43.9,50.6,0.1,0.4,0.8,5.4,6.6,0.9,99.5,0.0,0.0
EAST WORTHING AND SHOREHAM,45158,45148,7952,36679,0,16,32,469,44631,36679,0,16,48,517,202,72,44841,0,0,17.6,81.2,0.0,0.0,0.1,1.0,17.6,81.2,0.0,0.0,0.1,1.1,0.4,0.2,99.3,0.0,0.0
EAST YORKSHIRE,51912,51873,42879,3976,310,430,561,3717,46855,3976,310,740,1301,5018,2666,1377,49646,20838,15664,82.6,7.7,0.6,0.8,1.1,7.2,82.6,7.7,0.6,1.4,2.5,9.7,5.1,2.7,95.6,40.1,30.2
EDDISBURY,43757,43727,32951,5119,414,794,804,3645,38070,5119,414,1208,2012,5657,4113,2129,42337,2253,88,75.3,11.7,0.9,1.8,1.8,8.3,75.3,11.7,0.9,2.8,4.6,12.9,9.4,4.9,96.8,5.1,0.2
EDINBURGH EAST,55187,55186,9021,44031,2,17,141,1974,53052,44031,2,19,160,2134,18882,992,53138,0,0,16.3,79.8,0.0,0.0,0.3,3.6,16.3,79.8,0.0,0.0,0.3,3.9,34.2,1.8,96.3,0.0,0.0
EDINBURGH NORTH AND LEITH,67995,67991,12506,54133,0,177,32,1143,66639,54133,0,177,209,1352,7688,233,66661,0,0,18.4,79.6,0.0,0.3,0.0,1.7,18.4,79.6,0.0,0.3,0.3,2.0,11.3,0.3,98.0,0.0,0.0
EDINBURGH SOUTH,41612,41610,5073,35882,1,21,18,615,40955,35882,1,22,40,655,6989,61,41022,0,0,12.2,86.2,0.0,0.1,0.0,1.5,12.2,86.2,0.0,0.1,0.1,1.6,16.8,0.1,98.6,0.0,0.0
EDINBURGH SOUTH WEST,53641,53638,5463,46526,54,20,96,1479,51989,46526,54,74,170,1649,9198,189,52298,0,0,10.2,86.7,0.1,0.0,0.2,2.8,10.2,86.7,0.1,0.1,0.3,3.1,17.1,0.4,97.5,0.0,0.0
EDINBURGH WEST,45696,45688,8932,35115,59,282,229,1071,44047,35115,59,341,570,1641,13690,590,44841,0,0,19.5,76.8,0.1,0.6,0.5,2.3,19.5,76.8,0.1,0.7,1.2,3.6,30.0,1.3,98.1,0.0,0.0
EDMONTON,44925,44699,9190,34278,0,33,387,811,43468,34278,0,33,420,1231,1019,743,43491,0,0,20.5,76.3,0.0,0.1,0.9,1.8,20.5,76.3,0.0,0.1,0.9,2.7,2.3,1.7,96.8,0.0,0.0
ELLESMERE PORT AND NESTON,43759,43750,19286,23183,18,80,62,1121,42469,23183,18,98,160,1281,1096,169,43461,4868,0,44.1,53.0,0.0,0.2,0.1,2.6,44.1,53.0,0.0,0.2,0.4,2.9,2.5,0.4,99.3,11.1,0.0
ELMET AND ROTHWELL,47897,47866,16372,28110,111,509,345,2419,44482,28110,111,620,965,3384,20937,1046,46308,1088,748,34.2,58.7,0.2,1.1,0.7,5.1,34.2,58.7,0.2,1.3,2.0,7.1,43.7,2.2,96.7,2.3,1.6
ELTHAM,40441,40440,6042,34091,0,10,6,291,40133,34091,0,10,16,307,1589,21,40233,0,0,14.9,84.3,0.0,0.0,0.0,0.7,14.9,84.3,0.0,0.0,0.0,0.8,3.9,0.1,99.5,0.0,0.0
ENFIELD NORTH,44681,44424,9031,34587,33,61,304,408,43618,34587,33,94,398,806,1381,717,43823,0,0,20.2,77.4,0.1,0.1,0.7,0.9,20.2,77.4,0.1,0.2,0.9,1.8,3.1,1.6,98.1,0.0,0.0
"ENFIELD, SOUTHGATE",42351,42111,7776,33475,0,1,57,802,41251,33475,0,1,58,860,329,310,41528,0,0,18.4,79.0,0.0,0.0,0.1,1.9,18.4,79.0,0.0,0.0,0.1,2.0,0.8,0.7,98.1,0.0,0.0
EPPING FOREST,46040,45963,9098,35039,59,320,388,1059,44137,35039,59,379,767,1826,1016,854,45441,0,0,19.8,76.1,0.1,0.7,0.8,2.3,19.8,76.1,0.1,0.8,1.7,4.0,2.2,1.9,98.7,0.0,0.0
EPSOM AND EWELL,45793,45790,8905,36483,0,46,8,348,45388,36483,0,46,54,402,997,57,45613,0,0,19.4,79.7,0.0,0.1,0.0,0.8,19.4,79.7,0.0,0.1,0.1,0.9,2.2,0.1,99.6,0.0,0.0
EREWASH,47195,47142,8973,37703,4,34,52,376,46676,37703,4,38,90,466,311,144,47027,0,0,19.0,79.9,0.0,0.1,0.1,0.8,19.0,79.9,0.0,0.1,0.2,1.0,0.7,0.3,99.6,0.0,0.0
ERITH AND THAMESMEAD,46290,46268,11084,33898,24,136,653,473,44982,33898,24,160,813,1286,903,913,45035,0,0,23.9,73.2,0.1,0.3,1.4,1.0,23.9,73.2,0.1,0.3,1.8,2.8,2.0,2.0,97.3,0.0,0.0
ESHER AND WALTON,49227,49203,9593,38982,1,15,21,591,48575,38982,1,16,37,628,1161,65,49128,0,0,19.5,79.2,0.0,0.0,0.0,1.2,19.5,79.2,0.0,0.0,0.1,1.3,2.4,0.1,99.8,0.0,0.0
EXETER,50433,50409,5548,42734,26,71,844,1186,48282,42734,26,97,941,2127,19947,1222,48462,22810,6469,11.0,84.7,0.1,0.1,1.7,2.4,11.0,84.7,0.1,0.2,1.9,4.2,39.6,2.4,96.1,45.2,12.8
FALKIRK,50876,50861,9705,39668,48,162,185,1093,49373,39668,48,210,395,1488,392,484,50218,0,0,19.1,78.0,0.1,0.3,0.4,2.1,19.1,78.0,0.1,0.4,0.8,2.9,0.8,1.0,98.7,0.0,0.0
FAREHAM,46215,46197,9568,35767,8,86,124,644,45335,35767,8,94,218,862,2019,241,45988,0,0,20.7,77.4,0.0,0.2,0.3,1.4,20.7,77.4,0.0,0.2,0.5,1.9,4.4,0.5,99.5,0.0,0.0
FAVERSHAM AND MID KENT,44375,44269,25060,14630,388,530,784,2877,39690,14630,388,918,1702,4579,2769,1871,43574,0,0,56.5,33.0,0.9,1.2,1.8,6.5,56.5,33.0,0.9,2.1,3.8,10.3,6.2,4.2,98.2,0.0,0.0
FELTHAM AND HESTON,44454,44370,5737,37421,0,102,178,932,43158,37421,0,102,280,1212,2164,401,43197,0,0,12.9,84.2,0.0,0.2,0.4,2.1,12.9,84.2,0.0,0.2,0.6,2.7,4.9,0.9,97.2,0.0,0.0
FERMANAGH AND SOUTH TYRONE,45778,45189,23439,8989,3054,2269,2363,5075,32428,8989,3054,5323,7686,12761,8989,8296,44741,20369,5023,51.2,19.6,6.7,5.0,5.2,11.1,51.2,19.6,6.7,11.6,16.8,27.9,19.6,18.1,97.7,44.5,11.0
FILTON AND BRADLEY STOKE,45773,45735,10365,34305,17,27,258,763,44670,34305,17,44,302,1065,3718,363,45364,0,0,22.6,74.9,0.0,0.1,0.6,1.7,22.6,74.9,0.0,0.1,0.7,2.3,8.1,0.8,99.1,0.0,0.0
FINCHLEY AND GOLDERS GREEN,52745,52741,23221,28181,0,1,4,1334,51402,28181,0,1,5,1339,3774,148,51963,0,0,44.0,53.4,0.0,0.0,0.0,2.5,44.0,53.4,0.0,0.0,0.0,2.5,7.2,0.3,98.5,0.0,0.0
FOLKESTONE AND HYTHE,56577,56546,31598,20467,314,493,864,2810,52065,20467,314,807,1671,4481,1025,1793,55226,0,0,55.8,36.2,0.6,0.9,1.5,5.0,55.8,36.2,0.6,1.4,3.0,7.9,1.8,3.2,97.6,0.0,0.0
FOREST OF DEAN,43507,43474,27817,6005,300,1216,2283,5853,33822,6005,300,1516,3799,9652,5275,4419,38014,5955,2790,63.9,13.8,0.7,2.8,5.2,13.5,63.9,13.8,0.7,3.5,8.7,22.2,12.1,10.2,87.4,13.7,6.4
FOYLE,43484,43408,6015,36202,136,75,124,856,42217,36202,136,211,335,1191,6543,419,43116,0,0,13.8,83.3,0.3,0.2,0.3,2.0,13.8,83.3,0.3,0.5,0.8,2.7,15.0,1.0,99.2,0.0,0.0
FYLDE,39618,39395,23627,12763,21,266,191,2527,36390,12763,21,287,478,3005,1540,726,38475,3824,1232,59.6,32.2,0.1,0.7,0.5,6.4,59.6,32.2,0.1,0.7,1.2,7.6,3.9,1.8,97.1,9.7,3.1
GAINSBOROUGH,46826,46699,28226,11555,943,1232,1249,3494,39781,11555,943,2175,3424,6918,5934,3631,45459,12123,8695,60.3,24.7,2.0,2.6,2.7,7.5,60.3,24.7,2.0,4.6,7.3,14.8,12.7,7.8,97.1,25.9,18.6
GARSTON AND HALEWOOD,47572,47571,13816,33236,5,18,63,433,47052,33236,5,23,86,519,2467,107,47322,0,0,29.0,69.9,0.0,0.0,0.1,0.9,29.0,69.9,0.0,0.0,0.2,1.1,5.2,0.2,99.5,0.0,0.0
GATESHEAD,48212,48174,8141,39045,0,8,225,755,47186,39045,0,8,233,988,936,304,47229,0,0,16.9,81.0,0.0,0.0,0.5,1.6,16.9,81.0,0.0,0.0,0.5,2.0,1.9,0.6,98.0,0.0,0.0
GEDLING,44613,44608,3406,41007,0,35,12,148,44413,41007,0,35,47,195,14851,53,44549,0,0,7.6,91.9,0.0,0.1,0.0,0.3,7.6,91.9,0.0,0.1,0.1,0.4,33.3,0.1,99.9,0.0,0.0
GILLINGHAM AND RAINHAM,43808,43790,3980,39230,3,56,76,445,43210,39230,3,59,135,580,229,176,43558,0,0,9.1,89.5,0.0,0.1,0.2,1.0,9.1,89.5,0.0,0.1,0.3,1.3,0.5,0.4,99.4,0.0,0.0
GLASGOW CENTRAL,36189,36157,12750,17745,0,6,246,5410,30495,17745,0,6,252,5662,5387,349,30643,0,0,35.2,49.0,0.0,0.0,0.7,14.9,35.2,49.0,0.0,0.0,0.7,15.6,14.9,1.0,84.7,0.0,0.0
GLASGOW EAST,32925,32845,13443,18670,0,13,192,527,32113,18670,0,13,205,732,4006,367,32347,0,0,40.8,56.7,0.0,0.0,0.6,1.6,40.8,56.7,0.0,0.0,0.6,2.2,12.2,1.1,98.2,0.0,0.0
GLASGOW NORTH,15187,15076,5863,9017,12,16,42,126,14880,9017,12,28,70,196,509,190,14985,0,0,38.6,59.4,0.1,0.1,0.3,0.8,38.6,59.4,0.1,0.2,0.5,1.3,3.4,1.3,98.7,0.0,0.0
GLASGOW NORTH EAST,24780,24767,10161,14155,0,44,30,377,24316,14155,0,44,74,451,1640,110,24558,0,0,41.0,57.1,0.0,0.2,0.1,1.5,41.0,57.1,0.0,0.2,0.3,1.8,6.6,0.4,99.1,0.0,0.0
GLASGOW NORTH WEST,23327,23304,9459,13707,3,1,25,109,23166,13707,3,4,29,138,230,55,23216,0,0,40.5,58.8,0.0,0.0,0.1,0.5,40.5,58.8,0.0,0.0,0.1,0.6,1.0,0.2,99.5,0.0,0.0
GLASGOW SOUTH,22358,22344,5837,15985,1,7,76,438,21822,15985,1,8,84,522,900,113,22019,0,0,26.1,71.5,0.0,0.0,0.3,2.0,26.1,71.5,0.0,0.0,0.4,2.3,4.0,0.5,98.5,0.0,0.0
GLASGOW SOUTH WEST,29939,29936,18367,10965,28,60,107,409,29332,10965,28,88,195,604,2546,209,29598,0,0,61.3,36.6,0.1,0.2,0.4,1.4,61.3,36.6,0.1,0.3,0.7,2.0,8.5,0.7,98.9,0.0,0.0
GLENROTHES,44939,44905,12393,30520,52,71,587,1282,42913,30520,52,123,710,1992,84,818,44316,0,0,27.6,67.9,0.1,0.2,1.3,2.9,27.6,67.9,0.1,0.3,1.6,4.4,0.2,1.8,98.6,0.0,0.0
GLOUCESTER,55495,55491,8809,45303,1,66,262,1050,54112,45303,1,67,329,1379,2785,628,54417,26918,1258,15.9,81.6,0.0,0.1,0.5,1.9,15.9,81.6,0.0,0.1,0.6,2.5,5.0,1.1,98.1,48.5,2.3
GORDON,49884,49779,39542,1607,902,1250,1729,4749,41149,1607,902,2152,3881,8630,1355,4295,47155,0,0,79.3,3.2,1.8,2.5,3.5,9.5,79.3,3.2,1.8,4.3,7.8,17.3,2.7,8.6,94.5,0.0,0.0
GOSPORT,45180,45165,9700,35387,1,8,0,69,45087,35387,1,9,9,78,380,24,45153,0,0,21.5,78.3,0.0,0.0,0.0,0.2,21.5,78.3,0.0,0.0,0.0,0.2,0.8,0.1,99.9,0.0,0.0
GOWER,38286,38235,17867,18280,110,141,255,1582,36147,18280,110,251,506,2088,3851,623,37142,4392,656,46.7,47.7,0.3,0.4,0.7,4.1,46.7,47.7,0.3,0.7,1.3,5.5,10.1,1.6,97.0,11.5,1.7
GRANTHAM AND STAMFORD,53877,53857,31524,18431,339,255,475,2833,49955,18431,339,594,1069,3902,1362,1191,52663,0,0,58.5,34.2,0.6,0.5,0.9,5.3,58.5,34.2,0.6,1.1,2.0,7.2,2.5,2.2,97.7,0.0,0.0
GRAVESHAM,44992,44981,13780,29245,17,176,162,1601,43025,29245,17,193,355,1956,2829,366,44329,0,0,30.6,65.0,0.0,0.4,0.4,3.6,30.6,65.0,0.0,0.4,0.8,4.3,6.3,0.8,98.5,0.0,0.0
GREAT GRIMSBY,40489,40458,3658,36025,0,35,107,633,39683,36025,0,35,142,775,58,225,39821,11027,9895,9.0,89.0,0.0,0.1,0.3,1.6,9.0,89.0,0.0,0.1,0.4,1.9,0.1,0.6,98.4,27.2,24.4
GREAT YARMOUTH,48928,48898,22833,24229,17,111,139,1569,47062,24229,17,128,267,1836,1160,335,48486,0,0,46.7,49.5,0.0,0.2,0.3,3.2,46.7,49.5,0.0,0.3,0.5,3.8,2.4,0.7,99.1,0.0,0.0
GREENWICH AND WOOLWICH,63190,63167,16183,44922,0,130,652,1280,61105,44922,0,130,782,2062,12936,919,61347,0,0,25.6,71.1,0.0,0.2,1.0,2.0,25.6,71.1,0.0,0.2,1.2,3.3,20.5,1.5,97.1,0.0,0.0
GUILDFORD,45928,45926,13920,29994,35,134,263,1580,43914,29994,35,169,432,2012,1937,444,45532,0,0,30.3,65.3,0.1,0.3,0.6,3.4,30.3,65.3,0.1,0.4,0.9,4.4,4.2,1.0,99.1,0.0,0.0
HACKNEY NORTH AND STOKE NEWINGTON,58989,58959,12672,45494,0,0,1,792,58166,45494,0,0,1,793,4235,40,58171,0,0,21.5,77.1,0.0,0.0,0.0,1.3,21.5,77.1,0.0,0.0,0.0,1.3,7.2,0.1,98.6,0.0,0.0
HACKNEY SOUTH AND SHOREDITCH,65226,65102,22186,40385,0,0,228,2303,62571,40385,0,0,228,2531,8421,367,62608,0,0,34.0,61.9,0.0,0.0,0.3,3.5,34.0,61.9,0.0,0.0,0.3,3.9,12.9,0.6,96.0,0.0,0.0
HALESOWEN AND ROWLEY REGIS,41305,41271,7245,33861,0,0,38,127,41106,33861,0,0,38,165,436,78,41145,0,0,17.5,82.0,0.0,0.0,0.1,0.3,17.5,82.0,0.0,0.0,0.1,0.4,1.1,0.2,99.6,0.0,0.0
HALIFAX,50960,50956,22445,27153,5,54,56,1243,49598,27153,5,59,115,1358,487,130,50428,16,15,44.0,53.3,0.0,0.1,0.1,2.4,44.0,53.3,0.0,0.1,0.2,2.7,1.0,0.3,99.0,0.0,0.0
HALTEMPRICE AND HOWDEN,41440,41113,9772,29909,184,137,185,926,39681,29909,184,321,506,1432,29908,861,40661,10756,6476,23.6,72.2,0.4,0.3,0.4,2.2,23.6,72.2,0.4,0.8,1.2,3.5,72.2,2.1,98.1,26.0,15.6
HALTON,47681,47668,15896,30688,1,27,155,901,46584,30688,1,28,183,1084,604,212,47407,8,0,33.3,64.4,0.0,0.1,0.3,1.9,33.3,64.4,0.0,0.1,0.4,2.3,1.3,0.4,99.4,0.0,0.0
HAMMERSMITH,58407,58313,20512,34625,0,66,141,2969,55137,34625,0,66,207,3176,8014,306,55147,0,0,35.1,59.3,0.0,0.1,0.2,5.1,35.1,59.3,0.0,0.1,0.4,5.4,13.7,0.5,94.4,0.0,0.0
HAMPSTEAD AND KILBURN,65595,65412,13822,50560,0,0,39,991,64382,50560,0,0,39,1030,2380,240,64388,0,0,21.1,77.1,0.0,0.0,0.1,1.5,21.1,77.1,0.0,0.0,0.1,1.6,3.6,0.4,98.2,0.0,0.0
HARBOROUGH,48060,47998,18753,28209,28,34,83,891,46962,28209,28,62,145,1036,1149,269,47781,0,0,39.0,58.7,0.1,0.1,0.2,1.9,39.0,58.7,0.1,0.1,0.3,2.2,2.4,0.6,99.4,0.0,0.0
HARLOW,48028,48015,6784,38561,18,71,296,2285,45345,38561,18,89,385,2670,1578,474,45773,0,0,14.1,80.3,0.0,0.1,0.6,4.8,14.1,80.3,0.0,0.2,0.8,5.6,3.3,1.0,95.3,0.0,0.0
HARROGATE AND KNARESBOROUGH,50880,50875,10891,38023,52,128,143,1638,48914,38023,52,180,323,1961,813,397,49844,4104,313,21.4,74.7,0.1,0.3,0.3,3.2,21.4,74.7,0.1,0.4,0.6,3.9,1.6,0.8,98.0,8.1,0.6
HARROW EAST,39729,39716,6688,32271,0,1,298,458,38959,32271,0,1,299,757,6971,342,39032,0,0,16.8,81.2,0.0,0.0,0.8,1.2,16.8,81.2,0.0,0.0,0.8,1.9,17.5,0.9,98.2,0.0,0.0
HARROW WEST,45118,45097,7446,36294,0,6,71,1280,43740,36294,0,6,77,1357,3405,119,43751,0,0,16.5,80.4,0.0,0.0,0.2,2.8,16.5,80.4,0.0,0.0,0.2,3.0,7.5,0.3,97.0,0.0,0.0
HARTLEPOOL,47177,47148,6104,39190,122,150,347,1235,45294,39190,122,272,619,1854,132,725,45551,597,4,12.9,83.1,0.3,0.3,0.7,2.6,12.9,83.1,0.3,0.6,1.3,3.9,0.3,1.5,96.6,1.3,0.0
HARWICH AND NORTH ESSEX,44325,44090,32869,2888,800,1303,1606,4624,35757,2888,800,2103,3709,8333,2606,4294,39621,0,0,74.2,6.5,1.8,2.9,3.6,10.4,74.2,6.5,1.8,4.7,8.4,18.8,5.9,9.7,89.4,0.0,0.0
HASTINGS AND RYE,56963,56947,54309,739,30,44,88,1737,55048,739,30,74,162,1899,739,179,56883,0,0,95.3,1.3,0.1,0.1,0.2,3.0,95.3,1.3,0.1,0.1,0.3,3.3,1.3,0.3,99.9,0.0,0.0
HAVANT,43977,43931,7782,35745,2,5,75,322,43527,35745,2,7,82,404,442,128,43807,0,0,17.7,81.3,0.0,0.0,0.2,0.7,17.7,81.3,0.0,0.0,0.2,0.9,1.0,0.3,99.6,0.0,0.0
HAYES AND HARLINGTON,45484,45192,5216,38388,27,47,381,1133,43604,38388,27,74,455,1588,3314,910,43624,0,0,11.5,84.4,0.1,0.1,0.8,2.5,11.5,84.4,0.1,0.2,1.0,3.5,7.3,2.0,95.9,0.0,0.0
HAZEL GROVE,37961,37950,6699,30411,22,136,59,623,37110,30411,22,158,217,840,116,271,37593,6135,0,17.6,80.1,0.1,0.4,0.2,1.6,17.6,80.1,0.1,0.4,0.6,2.2,0.3,0.7,99.0,16.2,0.0
HEMEL HEMPSTEAD,47184,47162,11523,33821,101,130,543,1044,45344,33821,101,231,774,1818,1117,852,46323,0,0,24.4,71.7,0.2,0.3,1.2,2.2,24.4,71.7,0.2,0.5,1.6,3.9,2.4,1.8,98.2,0.0,0.0
HEMSWORTH,45766,45705,38380,4026,25,224,254,2796,42406,4026,25,249,503,3299,2080,571,44952,300,0,83.9,8.8,0.1,0.5,0.6,6.1,83.9,8.8,0.1,0.5,1.1,7.2,4.5,1.2,98.2,0.7,0.0
HENDON,56275,56268,25542,29183,0,7,37,1499,54725,29183,0,7,44,1543,7363,128,55280,0,0,45.4,51.9,0.0,0.0,0.1,2.7,45.4,51.9,0.0,0.0,0.1,2.7,13.1,0.2,98.2,0.0,0.0
HENLEY,46485,46442,34737,8929,102,196,288,2190,43666,8929,102,298,586,2776,4747,657,46169,0,0,74.7,19.2,0.2,0.4,0.6,4.7,74.7,19.2,0.2,0.6,1.3,6.0,10.2,1.4,99.3,0.0,0.0
HEREFORD AND SOUTH HEREFORDSHIRE,47274,47216,37739,5204,432,484,891,2466,42943,5204,432,916,1807,4273,4085,1938,45569,5259,1520,79.8,11.0,0.9,1.0,1.9,5.2,79.8,11.0,0.9,1.9,3.8,9.0,8.6,4.1,96.4,11.1,3.2
HERTFORD AND STORTFORD,51041,51032,11130,38049,47,109,102,1595,49179,38049,47,156,258,1853,1570,289,50139,0,0,21.8,74.5,0.1,0.2,0.2,3.1,21.8,74.5,0.1,0.3,0.5,3.6,3.1,0.6,98.2,0.0,0.0
HERTSMERE,46008,45999,10006,34909,6,98,90,890,44915,34909,6,104,194,1084,1242,221,45483,0,0,21.7,75.9,0.0,0.2,0.2,1.9,21.7,75.9,0.0,0.2,0.4,2.4,2.7,0.5,98.9,0.0,0.0
HEXHAM,35871,35734,28747,1880,859,662,600,2986,30627,1880,859,1521,2121,5107,1475,2273,35252,3150,801,80.1,5.2,2.4,1.8,1.7,8.3,80.1,5.2,2.4,4.2,5.9,14.2,4.1,6.3,98.3,8.8,2.2
HEYWOOD AND MIDDLETON,51036,50997,21438,28170,17,27,83,1262,49608,28170,17,44,127,1389,644,188,50577,0,0,42.0,55.2,0.0,0.1,0.2,2.5,42.0,55.2,0.0,0.1,0.2,2.7,1.3,0.4,99.1,0.0,0.0
HIGH PEAK,45882,45791,39449,1839,343,533,507,3120,41288,1839,343,876,1383,4503,1216,1508,45055,0,0,86.0,4.0,0.7,1.2,1.1,6.8,86.0,4.0,0.7,1.9,3.0,9.8,2.7,3.3,98.2,0.0,0.0
HITCHIN AND HARPENDEN,45309,45290,11145,31524,109,150,321,2041,42669,31524,109,259,580,2621,525,628,44156,0,0,24.6,69.6,0.2,0.3,0.7,4.5,24.6,69.6,0.2,0.6,1.3,5.8,1.2,1.4,97.5,0.0,0.0
HOLBORN AND ST PANCRAS,75972,75906,8875,62308,0,0,4,4719,71183,62308,0,0,4,4723,10928,83,71186,0,0,11.7,82.0,0.0,0.0,0.0,6.2,11.7,82.0,0.0,0.0,0.0,6.2,14.4,0.1,93.7,0.0,0.0
HORNCHURCH AND UPMINSTER,48135,47889,8284,38252,59,97,100,1097,46536,38252,59,156,256,1353,712,584,47192,0,0,17.2,79.5,0.1,0.2,0.2,2.3,17.2,79.5,0.1,0.3,0.5,2.8,1.5,1.2,98.0,0.0,0.0
HORNSEY AND WOOD GREEN,54431,54408,11007,42181,0,1,160,1059,53188,42181,0,1,161,1220,789,275,53312,0,0,20.2,77.5,0.0,0.0,0.3,1.9,20.2,77.5,0.0,0.0,0.3,2.2,1.4,0.5,97.9,0.0,0.0
HORSHAM,51807,51784,38509,9820,76,244,407,2728,48329,9820,76,320,727,3455,4560,757,51390,0,0,74.3,19.0,0.1,0.5,0.8,5.3,74.3,19.0,0.1,0.6,1.4,6.7,8.8,1.5,99.2,0.0,0.0
HOUGHTON AND SUNDERLAND SOUTH,43419,43358,19467,21683,37,67,352,1752,41150,21683,37,104,456,2208,5697,628,42510,0,0,44.8,49.9,0.1,0.2,0.8,4.0,44.8,49.9,0.1,0.2,1.1,5.1,13.1,1.4,97.9,0.0,0.0
HOVE,52217,52199,8618,42559,0,7,96,919,51177,42559,0,7,103,1022,356,179,51194,0,0,16.5,81.5,0.0,0.0,0.2,1.8,16.5,81.5,0.0,0.0,0.2,2.0,0.7,0.3,98.0,0.0,0.0
HUDDERSFIELD,45482,45475,5883,39123,1,59,88,321,45006,39123,1,60,148,469,2541,164,45239,0,0,12.9,86.0,0.0,0.1,0.2,0.7,12.9,86.0,0.0,0.1,0.3,1.0,5.6,0.4,99.5,0.0,0.0
HUNTINGDON,55572,55503,17173,36694,90,172,355,1019,53867,36694,90,262,617,1636,2508,754,54977,0,0,30.9,66.0,0.2,0.3,0.6,1.8,30.9,66.0,0.2,0.5,1.1,2.9,4.5,1.4,98.9,0.0,0.0
HYNDBURN,46845,46789,19703,25766,18,31,52,1219,45469,25766,18,49,101,1320,233,158,46461,18604,10269,42.1,55.0,0.0,0.1,0.1,2.6,42.1,55.0,0.0,0.1,0.2,2.8,0.5,0.3,99.2,39.7,21.9
ILFORD NORTH,41698,41690,4477,36546,14,54,99,500,41023,36546,14,68,167,667,898,276,41142,0,0,10.7,87.6,0.0,0.1,0.2,1.2,10.7,87.6,0.0,0.2,0.4,1.6,2.2,0.7,98.7,0.0,0.0
ILFORD SOUTH,47294,47284,7587,39098,0,0,2,597,46685,39098,0,0,2,599,8750,15,46774,0,0,16.0,82.7,0.0,0.0,0.0,1.3,16.0,82.7,0.0,0.0,0.0,1.3,18.5,0.0,98.9,0.0,0.0
INVERCLYDE,41953,41916,10518,30199,41,83,135,940,40717,30199,41,124,259,1199,3624,316,41314,0,0,25.1,72.0,0.1,0.2,0.3,2.2,25.1,72.0,0.1,0.3,0.6,2.9,8.6,0.8,98.5,0.0,0.0
"INVERNESS, NAIRN, BADENOCH AND STRATHSPEY",52196,51843,43198,1191,722,661,1136,4935,44389,1191,722,1383,2519,7454,1191,2988,50278,589,165,82.8,2.3,1.4,1.3,2.2,9.5,82.8,2.3,1.4,2.6,4.8,14.3,2.3,5.7,96.3,1.1,0.3
IPSWICH,54220,54191,12122,41423,0,26,82,538,53545,41423,0,26,108,646,1098,137,53640,0,0,22.4,76.4,0.0,0.0,0.2,1.0,22.4,76.4,0.0,0.0,0.2,1.2,2.0,0.3,98.9,0.0,0.0
ISLE OF WIGHT,78218,78060,72751,665,228,338,460,3618,73416,665,228,566,1026,4644,13838,1184,77867,0,0,93.0,0.9,0.3,0.4,0.6,4.6,93.0,0.9,0.3,0.7,1.3,5.9,17.7,1.5,99.6,0.0,0.0
ISLINGTON NORTH,55123,55120,5012,48487,0,0,5,1616,53499,48487,0,0,5,1621,2151,192,53522,0,0,9.1,88.0,0.0,0.0,0.0,2.9,9.1,88.0,0.0,0.0,0.0,2.9,3.9,0.3,97.1,0.0,0.0
ISLINGTON SOUTH AND FINSBURY,66338,66310,17516,43517,0,0,16,5261,61033,43517,0,0,16,5277,7673,55,61040,0,0,26.4,65.6,0.0,0.0,0.0,7.9,26.4,65.6,0.0,0.0,0.0,8.0,11.6,0.1,92.0,0.0,0.0
ISLWYN,35045,35035,28282,5460,16,31,51,1195,33742,5460,16,47,98,1293,5330,112,34994,5834,3075,80.7,15.6,0.0,0.1,0.1,3.4,80.7,15.6,0.0,0.1,0.3,3.7,15.2,0.3,99.9,16.6,8.8
JARROW,41021,41018,14408,25258,32,195,189,936,39666,25258,32,227,416,1352,332,457,40324,0,0,35.1,61.6,0.1,0.5,0.5,2.3,35.1,61.6,0.1,0.6,1.0,3.3,0.8,1.1,98.3,0.0,0.0
KEIGHLEY,42950,42927,16150,24454,118,173,328,1704,40604,24454,118,291,619,2323,374,667,42104,33333,22958,37.6,56.9,0.3,0.4,0.8,4.0,37.6,56.9,0.3,0.7,1.4,5.4,0.9,1.6,98.0,77.6,53.5
KENILWORTH AND SOUTHAM,40624,40596,20740,16681,246,344,280,2305,37421,16681,246,590,870,3175,3232,944,39675,223,16,51.1,41.1,0.6,0.8,0.7,5.7,51.1,41.1,0.6,1.5,2.1,7.8,8.0,2.3,97.7,0.5,0.0
KENSINGTON,72551,72536,11739,57195,0,0,52,3550,68934,57195,0,0,52,3602,3377,121,68935,0,0,16.2,78.8,0.0,0.0,0.1,4.9,16.2,78.8,0.0,0.0,0.1,5.0,4.7,0.2,95.0,0.0,0.0
KETTERING,48617,48276,21257,25457,41,193,263,1065,46714,25457,41,234,497,1562,3291,880,47106,34,0,43.7,52.4,0.1,0.4,0.5,2.2,43.7,52.4,0.1,0.5,1.0,3.2,6.8,1.8,96.9,0.1,0.0
KILMARNOCK AND LOUDOUN,46906,46868,24245,20190,244,249,740,1200,44435,20190,244,493,1233,2433,2571,1300,45826,0,0,51.7,43.0,0.5,0.5,1.6,2.6,51.7,43.0,0.5,1.1,2.6,5.2,5.5,2.8,97.7,0.0,0.0
KINGSTON AND SURBITON,52951,52926,4767,46711,9,37,86,1316,51478,46711,9,46,132,1448,807,265,51626,0,0,9.0,88.2,0.0,0.1,0.2,2.5,9.0,88.2,0.0,0.1,0.2,2.7,1.5,0.5,97.5,0.0,0.0
KINGSTON UPON HULL EAST,43556,43099,639,42015,3,11,152,279,42654,42015,3,14,166,445,42015,628,42654,5615,4783,1.5,96.5,0.0,0.0,0.3,0.6,1.5,96.5,0.0,0.0,0.4,1.0,96.5,1.4,97.9,12.9,11.0
KINGSTON UPON HULL NORTH,43809,43477,90,43151,1,13,52,170,43241,43151,1,14,66,236,43151,427,43241,9582,5151,0.2,98.5,0.0,0.0,0.1,0.4,0.2,98.5,0.0,0.0,0.2,0.5,98.5,1.0,98.7,21.9,11.8
KINGSTON UPON HULL WEST AND HESSLE,47374,46701,646,45647,1,8,57,342,46293,45647,1,9,66,408,45647,811,46293,13774,7154,1.4,96.4,0.0,0.0,0.1,0.7,1.4,96.4,0.0,0.0,0.1,0.9,96.4,1.7,97.7,29.1,15.1
KINGSWOOD,39888,39877,6456,33119,4,8,32,258,39575,33119,4,12,44,302,1364,65,39788,0,0,16.2,83.0,0.0,0.0,0.1,0.6,16.2,83.0,0.0,0.0,0.1,0.8,3.4,0.2,99.7,0.0,0.0
KIRKCALDY AND COWDENBEATH,51449,51407,26345,23694,30,103,62,1173,50039,23694,30,133,195,1368,4197,238,50865,0,0,51.2,46.1,0.1,0.2,0.1,2.3,51.2,46.1,0.1,0.3,0.4,2.7,8.2,0.5,98.9,0.0,0.0
KNOWSLEY,52023,52014,13409,37972,6,62,48,517,51381,37972,6,68,116,633,2269,130,51810,2186,0,25.8,73.0,0.0,0.1,0.1,1.0,25.8,73.0,0.0,0.1,0.2,1.2,4.4,0.2,99.6,4.2,0.0
LAGAN VALLEY,45848,45473,17934,23614,280,555,507,2583,41548,23614,280,835,1342,3925,10823,1747,45256,0,0,39.1,51.5,0.6,1.2,1.1,5.6,39.1,51.5,0.6,1.8,2.9,8.6,23.6,3.8,98.7,0.0,0.0
LANARK AND HAMILTON EAST,51019,50997,20269,28131,196,338,579,1484,48400,28131,196,534,1113,2597,6275,1171,50513,0,0,39.7,55.1,0.4,0.7,1.1,2.9,39.7,55.1,0.4,1.0,2.2,5.1,12.3,2.3,99.0,0.0,0.0
LANCASTER AND FLEETWOOD,41414,41399,30268,9325,101,110,178,1417,39593,9325,101,211,389,1806,4272,435,41107,282,67,73.1,22.5,0.2,0.3,0.4,3.4,73.1,22.5,0.2,0.5,0.9,4.4,10.3,1.1,99.3,0.7,0.2
LEEDS CENTRAL,75282,75263,8518,60691,4,141,251,5658,69209,60691,4,145,396,6054,20022,460,69243,0,0,11.3,80.6,0.0,0.2,0.3,7.5,11.3,80.6,0.0,0.2,0.5,8.0,26.6,0.6,92.0,0.0,0.0
LEEDS EAST,45346,45341,7117,37473,0,80,262,409,44590,37473,0,80,342,751,7030,368,44665,133,0,15.7,82.6,0.0,0.2,0.6,0.9,15.7,82.6,0.0,0.2,0.8,1.7,15.5,0.8,98.5,0.3,0.0
LEEDS NORTH EAST,42372,42367,2800,39192,4,6,48,317,41992,39192,4,10,58,375,27364,71,42076,666,0,6.6,92.5,0.0,0.0,0.1,0.7,6.6,92.5,0.0,0.0,0.1,0.9,64.6,0.2,99.3,1.6,0.0
LEEDS NORTH WEST,38003,37990,10961,25528,22,159,137,1183,36489,25528,22,181,318,1501,9271,339,37002,7031,273,28.8,67.2,0.1,0.4,0.4,3.1,28.8,67.2,0.1,0.5,0.8,3.9,24.4,0.9,97.4,18.5,0.7
LEEDS WEST,47404,47397,4616,42269,29,57,90,336,46885,42269,29,86,176,512,12009,197,47046,0,0,9.7,89.2,0.1,0.1,0.2,0.7,9.7,89.2,0.1,0.2,0.4,1.1,25.3,0.4,99.2,0.0,0.0
LEICESTER EAST,45047,45037,8902,35546,0,10,166,413,44448,35546,0,10,176,589,2321,286,44627,0,0,19.8,78.9,0.0,0.0,0.4,0.9,19.8,78.9,0.0,0.0,0.4,1.3,5.2,0.6,99.1,0.0,0.0
LEICESTER SOUTH,52352,52332,4198,47727,0,0,39,368,51925,47727,0,0,39,407,4129,70,51953,0,0,8.0,91.2,0.0,0.0,0.1,0.7,8.0,91.2,0.0,0.0,0.1,0.8,7.9,0.1,99.2,0.0,0.0
LEICESTER WEST,46495,46483,7485,38805,2,18,38,135,46290,38805,2,20,58,193,2195,80,46326,0,0,16.1,83.5,0.0,0.0,0.1,0.3,16.1,83.5,0.0,0.0,0.1,0.4,4.7,0.2,99.6,0.0,0.0
LEIGH,50108,50100,17998,31312,22,89,80,599,49310,31312,22,111,191,790,774,203,49932,1362,815,35.9,62.5,0.0,0.2,0.2,1.2,35.9,62.5,0.0,0.2,0.4,1.6,1.5,0.4,99.6,2.7,1.6
LEWES,43651,43637,37453,4196,54,116,191,1627,41649,4196,54,170,361,1988,4191,379,43542,0,0,85.8,9.6,0.1,0.3,0.4,3.7,85.8,9.6,0.1,0.4,0.8,4.6,9.6,0.9,99.8,0.0,0.0
"LEWISHAM, DEPTFORD",60063,60042,24189,32171,0,0,31,3651,56360,32171,0,0,31,3682,8321,236,56377,0,0,40.3,53.6,0.0,0.0,0.1,6.1,40.3,53.6,0.0,0.0,0.1,6.1,13.9,0.4,93.9,0.0,0.0
LEWISHAM EAST,48353,48336,10417,37536,0,0,50,333,47953,37536,0,0,50,383,1651,67,48171,0,0,21.5,77.6,0.0,0.0,0.1,0.7,21.5,77.6,0.0,0.0,0.1,0.8,3.4,0.1,99.6,0.0,0.0
LEWISHAM WEST AND PENGE,51905,51892,11667,38553,0,0,192,1480,50220,38553,0,0,192,1672,9140,250,50347,0,0,22.5,74.3,0.0,0.0,0.4,2.9,22.5,74.3,0.0,0.0,0.4,3.2,17.6,0.5,97.0,0.0,0.0
LEYTON AND WANSTEAD,42299,42286,5427,36073,0,20,34,732,41500,36073,0,20,54,786,4873,98,41508,0,0,12.8,85.3,0.0,0.0,0.1,1.7,12.8,85.3,0.0,0.0,0.1,1.9,11.5,0.2,98.1,0.0,0.0
LICHFIELD,44990,44977,14946,28132,117,213,300,1269,43078,28132,117,330,630,1899,1705,657,44704,0,0,33.2,62.5,0.3,0.5,0.7,2.8,33.2,62.5,0.3,0.7,1.4,4.2,3.8,1.5,99.4,0.0,0.0
LINCOLN,54067,54033,9522,43567,14,34,240,656,53089,43567,14,48,288,944,234,323,53271,12363,10424,17.6,80.6,0.0,0.1,0.4,1.2,17.6,80.6,0.0,0.1,0.5,1.7,0.4,0.6,98.5,22.9,19.3
LINLITHGOW AND EAST FALKIRK,55974,55959,22962,30395,60,197,292,2053,53357,30395,60,257,549,2602,4652,607,55285,0,0,41.0,54.3,0.1,0.4,0.5,3.7,41.0,54.3,0.1,0.5,1.0,4.6,8.3,1.1,98.8,0.0,0.0
"LIVERPOOL, RIVERSIDE",70260,70185,16653,42486,0,0,416,10630,59139,42486,0,0,416,11046,11772,781,59388,0,0,23.7,60.5,0.0,0.0,0.6,15.1,23.7,60.5,0.0,0.0,0.6,15.7,16.8,1.1,84.5,0.0,0.0
"LIVERPOOL, WALTON",46305,46303,12182,33650,0,31,3,437,45832,33650,0,31,34,471,356,36,45988,0,0,26.3,72.7,0.0,0.1,0.0,0.9,26.3,72.7,0.0,0.1,0.1,1.0,0.8,0.1,99.3,0.0,0.0
"LIVERPOOL, WAVERTREE",43831,43810,2860,40630,0,0,64,256,43490,40630,0,0,64,320,28741,88,43580,0,0,6.5,92.7,0.0,0.0,0.1,0.6,6.5,92.7,0.0,0.0,0.1,0.7,65.6,0.2,99.4,0.0,0.0
"LIVERPOOL, WEST DERBY",43007,43003,7789,34968,0,8,6,232,42757,34968,0,8,14,246,17559,26,42926,119,0,18.1,81.3,0.0,0.0,0.0,0.5,18.1,81.3,0.0,0.0,0.0,0.6,40.8,0.1,99.8,0.3,0.0
LIVINGSTON,51797,51785,17282,32872,84,135,251,1161,50154,32872,84,219,470,1631,3395,518,51068,0,0,33.4,63.5,0.2,0.3,0.5,2.2,33.4,63.5,0.2,0.4,0.9,3.1,6.6,1.0,98.6,0.0,0.0
LLANELLI,40492,40471,32009,5828,256,256,479,1643,37837,5828,256,512,991,2634,5828,1244,39442,3096,2624,79.1,14.4,0.6,0.6,1.2,4.1,79.1,14.4,0.6,1.3,2.4,6.5,14.4,3.1,97.4,7.6,6.5
LOUGHBOROUGH,45481,45471,12578,32235,69,64,86,439,44813,32235,69,133,219,658,1609,283,45220,0,0,27.7,70.9,0.2,0.1,0.2,1.0,27.7,70.9,0.2,0.3,0.5,1.4,3.5,0.6,99.4,0.0,0.0
LOUTH AND HORNCASTLE,50442,50413,36226,7463,600,897,1199,4028,43689,7463,600,1497,2696,6724,1295,2775,49278,5500,1932,71.8,14.8,1.2,1.8,2.4,8.0,71.8,14.8,1.2,3.0,5.3,13.3,2.6,5.5,97.7,10.9,3.8
LUDLOW,42009,41814,31643,1918,777,1509,1992,3975,33561,1918,777,2286,4278,8253,1918,4699,39108,22556,12423,75.3,4.6,1.8,3.6,4.7,9.5,75.3,4.6,1.8,5.4,10.2,19.6,4.6,11.2,93.1,53.7,29.6
LUTON NORTH,38794,38780,2008,36710,5,12,2,43,38718,36710,5,17,19,62,308,33,38755,0,0,5.2,94.6,0.0,0.0,0.0,0.1,5.2,94.6,0.0,0.0,0.0,0.2,0.8,0.1,99.9,0.0,0.0
LUTON SOUTH,51464,51452,5781,44847,43,236,61,484,50628,44847,43,279,340,824,4660,363,50797,0,0,11.2,87.1,0.1,0.5,0.1,0.9,11.2,87.1,0.1,0.5,0.7,1.6,9.1,0.7,98.7,0.0,0.0
MACCLESFIELD,46451,46430,12438,31242,130,328,507,1785,43680,31242,130,458,965,2750,1545,1006,45719,4463,1103,26.8,67.3,0.3,0.7,1.1,3.8,26.8,67.3,0.3,1.0,2.1,5.9,3.3,2.2,98.4,9.6,2.4
MAIDENHEAD,46242,46202,14450,28359,116,211,448,2618,42809,28359,116,327,775,3393,2598,916,45119,0,0,31.2,61.3,0.3,0.5,1.0,5.7,31.2,61.3,0.3,0.7,1.7,7.3,5.6,2.0,97.6,0.0,0.0
MAIDSTONE AND THE WEALD,49931,49881,22448,23176,54,670,740,2793,45624,23176,54,724,1464,4257,784,1551,48389,0,0,45.0,46.4,0.1,1.3,1.5,5.6,45.0,46.4,0.1,1.5,2.9,8.5,1.6,3.1,96.9,0.0,0.0
MAKERFIELD,44809,44804,9851,34299,1,9,39,605,44150,34299,1,10,49,654,71,58,44695,5243,84,22.0,76.5,0.0,0.0,0.1,1.4,22.0,76.5,0.0,0.0,0.1,1.5,0.2,0.1,99.7,11.7,0.2
MALDON,42060,42015,33638,4106,92,223,373,3583,37744,4106,92,315,688,4271,2234,759,41689,0,0,80.0,9.8,0.2,0.5,0.9,8.5,80.0,9.8,0.2,0.7,1.6,10.2,5.3,1.8,99.1,0.0,0.0
MANCHESTER CENTRAL,78708,78685,33059,36197,0,18,911,8500,69256,36197,0,18,929,9429,15942,1385,69648,2887,0,42.0,46.0,0.0,0.0,1.2,10.8,42.0,46.0,0.0,0.0,1.2,12.0,20.3,1.8,88.5,3.7,0.0
"MANCHESTER, GORTON",46675,46668,15490,30359,1,48,79,691,45849,30359,1,49,128,819,7014,208,45980,102,0,33.2,65.0,0.0,0.1,0.2,1.5,33.2,65.0,0.0,0.1,0.3,1.8,15.0,0.4,98.5,0.2,0.0
"MANCHESTER, WITHINGTON",44491,44485,5700,38010,0,0,97,678,43710,38010,0,0,97,775,655,119,43757,407,0,12.8,85.4,0.0,0.0,0.2,1.5,12.8,85.4,0.0,0.0,0.2,1.7,1.5,0.3,98.4,0.9,0.0
MANSFIELD,52429,52423,10583,41094,5,33,48,660,51677,41094,5,38,86,746,487,99,52248,0,0,20.2,78.4,0.0,0.1,0.1,1.3,20.2,78.4,0.0,0.1,0.2,1.4,0.9,0.2,99.7,0.0,0.0
MEON VALLEY,44068,44020,15967,24635,232,414,584,2188,40602,24635,232,646,1230,3418,2460,1315,43007,0,0,36.2,55.9,0.5,0.9,1.3,5.0,36.2,55.9,0.5,1.5,2.8,7.8,5.6,3.0,97.6,0.0,0.0
MERIDEN,51503,51484,14286,35359,28,279,445,1087,49645,35359,28,307,752,1839,4739,781,50613,0,0,27.7,68.7,0.1,0.5,0.9,2.1,27.7,68.7,0.1,0.6,1.5,3.6,9.2,1.5,98.3,0.0,0.0
MERTHYR TYDFIL AND RHYMNEY,36278,36261,34356,833,44,35,52,941,35189,833,44,79,131,1072,833,158,36177,4923,2089,94.7,2.3,0.1,0.1,0.1,2.6,94.7,2.3,0.1,0.2,0.4,3.0,2.3,0.4,99.7,13.6,5.8
MID BEDFORDSHIRE,50294,50290,20817,26587,71,251,445,2119,47404,26587,71,322,767,2886,4148,784,49580,0,0,41.4,52.9,0.1,0.5,0.9,4.2,41.4,52.9,0.1,0.6,1.5,5.7,8.2,1.6,98.6,0.0,0.0
MID DERBYSHIRE,39557,39544,16939,21165,74,144,173,1049,38104,21165,74,218,391,1440,1745,417,39314,0,0,42.8,53.5,0.2,0.4,0.4,2.7,42.8,53.5,0.2,0.6,1.0,3.6,4.4,1.1,99.4,0.0,0.0
MIDDLESBROUGH,46291,46257,4703,39944,67,210,292,1041,44647,39944,67,277,569,1610,332,781,44688,448,0,10.2,86.3,0.1,0.5,0.6,2.2,10.2,86.3,0.1,0.6,1.2,3.5,0.7,1.7,96.5,1.0,0.0
MIDDLESBROUGH SOUTH AND EAST CLEVELAND,45557,45554,5684,37408,108,332,405,1617,43092,37408,108,440,845,2462,550,877,44121,182,23,12.5,82.1,0.2,0.7,0.9,3.5,12.5,82.1,0.2,1.0,1.9,5.4,1.2,1.9,96.8,0.4,0.1
MID DORSET AND NORTH POOLE,37959,37914,17896,17695,41,115,140,2027,35591,17695,41,156,296,2323,2767,372,37121,4,4,47.1,46.6,0.1,0.3,0.4,5.3,47.1,46.6,0.1,0.4,0.8,6.1,7.3,1.0,97.8,0.0,0.0
MIDLOTHIAN,40073,39864,26836,10192,248,346,517,1725,37028,10192,248,594,1111,2836,10192,1326,39030,1511,1511,67.0,25.4,0.6,0.9,1.3,4.3,67.0,25.4,0.6,1.5,2.8,7.1,25.4,3.3,97.4,3.8,3.8
MID NORFOLK,50872,50774,42327,1697,390,870,1080,4410,44024,1697,390,1260,2340,6750,1695,2547,48862,0,0,83.2,3.3,0.8,1.7,2.1,8.7,83.2,3.3,0.8,2.5,4.6,13.3,3.3,5.0,96.0,0.0,0.0
MID SUSSEX,53053,52986,40029,10451,58,101,225,2122,50480,10451,58,159,384,2506,8747,454,52787,0,0,75.5,19.7,0.1,0.2,0.4,4.0,75.5,19.7,0.1,0.3,0.7,4.7,16.5,0.9,99.5,0.0,0.0
MID ULSTER,38520,38066,26431,3065,1189,1328,1465,4588,29496,3065,1189,2517,3982,8570,3065,4476,37441,1,0,68.6,8.0,3.1,3.4,3.8,11.9,68.6,8.0,3.1,6.5,10.3,22.2,8.0,11.6,97.2,0.0,0.0
MID WORCESTERSHIRE,50287,50012,41556,4958,64,309,459,2666,46514,4958,64,373,832,3498,2768,1199,49293,4958,556,82.6,9.9,0.1,0.6,0.9,5.3,82.6,9.9,0.1,0.7,1.7,7.0,5.5,2.4,98.0,9.9,1.1
MILTON KEYNES NORTH,59770,59751,33267,24341,24,215,544,1360,57608,24341,24,239,783,2143,21577,915,59010,0,0,55.7,40.7,0.0,0.4,0.9,2.3,55.7,40.7,0.0,0.4,1.3,3.6,36.1,1.5,98.7,0.0,0.0
MILTON KEYNES SOUTH,60696,60676,26250,32740,79,219,138,1250,58990,32740,79,298,436,1686,31345,469,60057,0,0,43.2,53.9,0.1,0.4,0.2,2.1,43.2,53.9,0.1,0.5,0.7,2.8,51.6,0.8,98.9,0.0,0.0
MITCHAM AND MORDEN,44121,44117,4994,38409,0,26,27,661,43403,38409,0,26,53,714,1410,218,43411,0,0,11.3,87.1,0.0,0.1,0.1,1.5,11.3,87.1,0.0,0.1,0.1,1.6,3.2,0.5,98.4,0.0,0.0
MOLE VALLEY,43208,43196,22038,18110,45,128,267,2608,40148,18110,45,173,440,3048,2561,462,43006,0,0,51.0,41.9,0.1,0.3,0.6,6.0,51.0,41.9,0.1,0.4,1.0,7.1,5.9,1.1,99.5,0.0,0.0
MONMOUTH,42067,41848,28756,6608,618,879,1183,3804,35364,6608,618,1497,2680,6484,4490,3014,40122,4323,2957,68.4,15.7,1.5,2.1,2.8,9.0,68.4,15.7,1.5,3.6,6.4,15.4,10.7,7.2,95.4,10.3,7.0
MONTGOMERYSHIRE,32074,31732,19227,6585,979,1200,1361,2380,25812,6585,979,2179,3540,5920,6585,3997,29625,6967,1459,59.9,20.5,3.1,3.7,4.2,7.4,59.9,20.5,3.1,6.8,11.0,18.5,20.5,12.5,92.4,21.7,4.5
MORAY,49033,48737,40380,503,794,1430,1298,4332,40883,503,794,2224,3522,7854,503,3994,46609,0,0,82.4,1.0,1.6,2.9,2.6,8.8,82.4,1.0,1.6,4.5,7.2,16.0,1.0,8.1,95.1,0.0,0.0
MORECAMBE AND LUNESDALE,44867,44859,20711,23520,59,22,67,480,44231,23520,59,81,148,628,3692,178,44747,302,10,46.2,52.4,0.1,0.0,0.1,1.1,46.2,52.4,0.1,0.2,0.3,1.4,8.2,0.4,99.7,0.7,0.0
MORLEY AND OUTWOOD,48346,48338,19061,27101,27,238,168,1743,46162,27101,27,265,433,2176,5281,487,47661,0,0,39.4,56.1,0.1,0.5,0.3,3.6,39.4,56.1,0.1,0.5,0.9,4.5,10.9,1.0,98.6,0.0,0.0
MOTHERWELL AND WISHAW,46136,46129,8476,37197,1,21,97,337,45673,37197,1,22,119,456,487,142,45909,0,0,18.4,80.6,0.0,0.0,0.2,0.7,18.4,80.6,0.0,0.0,0.3,1.0,1.1,0.3,99.5,0.0,0.0
NA H-EILEANAN AN IAR,16312,14881,11366,419,457,314,307,2018,11785,419,457,771,1078,3096,419,2545,14081,0,0,69.7,2.6,2.8,1.9,1.9,12.4,69.7,2.6,2.8,4.7,6.6,19.0,2.6,15.6,86.3,0.0,0.0
NEATH,35810,35800,19085,15377,77,76,101,1084,34462,15377,77,153,254,1338,1334,317,35593,4229,497,53.3,42.9,0.2,0.2,0.3,3.0,53.3,42.9,0.2,0.4,0.7,3.7,3.7,0.9,99.4,11.8,1.4
NEWARK,49552,49484,23328,23646,197,389,310,1614,46974,23646,197,586,896,2510,2824,1000,48868,437,119,47.1,47.7,0.4,0.8,0.6,3.3,47.1,47.7,0.4,1.2,1.8,5.1,5.7,2.0,98.6,0.9,0.2
NEWBURY,51497,51351,16770,32335,40,232,312,1662,49105,32335,40,272,584,2246,15412,813,49979,0,0,32.6,62.8,0.1,0.5,0.6,3.2,32.6,62.8,0.1,0.5,1.1,4.4,29.9,1.6,97.1,0.0,0.0
NEWCASTLE-UNDER-LYME,43706,43691,12720,29938,3,42,123,865,42658,29938,3,45,168,1033,2511,200,43423,265,0,29.1,68.5,0.0,0.1,0.3,2.0,29.1,68.5,0.0,0.1,0.4,2.4,5.7,0.5,99.4,0.6,0.0
NEWCASTLE UPON TYNE CENTRAL,51234,51171,12800,34520,0,1,69,3781,47320,34520,0,1,70,3851,4753,148,47386,0,0,25.0,67.4,0.0,0.0,0.1,7.4,25.0,67.4,0.0,0.0,0.1,7.5,9.3,0.3,92.5,0.0,0.0
NEWCASTLE UPON TYNE EAST,48356,48338,15355,31241,4,5,47,1686,46596,31241,4,9,56,1742,1186,90,46715,0,0,31.8,64.6,0.0,0.0,0.1,3.5,31.8,64.6,0.0,0.0,0.1,3.6,2.5,0.2,96.6,0.0,0.0
NEWCASTLE UPON TYNE NORTH,45357,45325,24910,19109,9,67,221,1009,44019,19109,9,76,297,1306,1223,377,44933,0,0,54.9,42.1,0.0,0.1,0.5,2.2,54.9,42.1,0.0,0.2,0.7,2.9,2.7,0.8,99.1,0.0,0.0
NEW FOREST EAST,42290,42265,28234,10422,271,161,391,2786,38656,10422,271,432,823,3609,772,904,41736,0,0,66.8,24.6,0.6,0.4,0.9,6.6,66.8,24.6,0.6,1.0,1.9,8.5,1.8,2.1,98.7,0.0,0.0
NEW FOREST WEST,44648,44612,34224,7284,238,354,286,2226,41508,7284,238,592,878,3104,7264,920,44201,0,0,76.7,16.3,0.5,0.8,0.6,5.0,76.7,16.3,0.5,1.3,2.0,7.0,16.3,2.1,99.0,0.0,0.0
NEWPORT EAST,37355,37342,12513,23767,25,101,251,685,36280,23767,25,126,377,1062,811,506,36603,14445,3090,33.5,63.6,0.1,0.3,0.7,1.8,33.5,63.6,0.1,0.3,1.0,2.8,2.2,1.4,98.0,38.7,8.3
NEWPORT WEST,42953,42941,16419,25417,50,112,106,837,41836,25417,50,162,268,1105,2304,295,42328,13224,2885,38.2,59.2,0.1,0.3,0.2,1.9,38.2,59.2,0.1,0.4,0.6,2.6,5.4,0.7,98.5,30.8,6.7
NEWRY AND ARMAGH,46157,45497,32631,4908,1287,1146,1173,4352,37539,4908,1287,2433,3606,7958,4908,4286,45086,1155,384,70.7,10.6,2.8,2.5,2.5,9.4,70.7,10.6,2.8,5.3,7.8,17.2,10.6,9.3,97.7,2.5,0.8
NEWTON ABBOT,45601,45548,24192,17374,185,433,603,2761,41566,17374,185,618,1221,3982,754,1300,44003,7899,112,53.1,38.1,0.4,0.9,1.3,6.1,53.1,38.1,0.4,1.4,2.7,8.7,1.7,2.9,96.5,17.3,0.2
"NORMANTON, PONTEFRACT AND CASTLEFORD",54706,54368,21572,30636,47,255,253,1605,52208,30636,47,302,555,2160,9962,1082,52937,332,0,39.4,56.0,0.1,0.5,0.5,2.9,39.4,56.0,0.1,0.6,1.0,3.9,18.2,2.0,96.8,0.6,0.0
NORTHAMPTON NORTH,41445,40753,9245,30922,0,8,42,536,40167,30922,0,8,50,586,1125,761,40189,298,0,22.3,74.6,0.0,0.0,0.1,1.3,22.3,74.6,0.0,0.0,0.1,1.4,2.7,1.8,97.0,0.7,0.0
NORTHAMPTON SOUTH,48772,47578,10696,36623,1,5,45,208,47319,36623,1,6,51,259,2512,1252,47406,924,0,21.9,75.1,0.0,0.0,0.1,0.4,21.9,75.1,0.0,0.0,0.1,0.5,5.2,2.6,97.2,1.9,0.0
NORTH ANTRIM,48095,47382,32293,7887,1193,1224,1139,3646,40180,7887,1193,2417,3556,7202,7886,4300,46798,0,0,67.1,16.4,2.5,2.5,2.4,7.6,67.1,16.4,2.5,5.0,7.4,15.0,16.4,8.9,97.3,0.0,0.0
NORTH AYRSHIRE AND ARRAN,50146,50112,40144,5857,264,308,600,2939,46001,5857,264,572,1172,4111,5857,1237,49416,0,0,80.1,11.7,0.5,0.6,1.2,5.9,80.1,11.7,0.5,1.1,2.3,8.2,11.7,2.5,98.5,0.0,0.0
NORTH CORNWALL,50671,50462,26367,18299,443,712,1128,3513,44666,18299,443,1155,2283,5796,18299,2623,48158,4187,1603,52.0,36.1,0.9,1.4,2.2,6.9,52.0,36.1,0.9,2.3,4.5,11.4,36.1,5.2,95.0,8.3,3.2
NORTH DEVON,50527,50443,41786,1371,661,1195,1913,3517,43157,1371,661,1856,3769,7286,1371,4085,47249,8071,2172,82.7,2.7,1.3,2.4,3.8,7.0,82.7,2.7,1.3,3.7,7.5,14.4,2.7,8.1,93.5,16.0,4.3
NORTH DORSET,45181,45158,38011,1790,281,647,747,3682,39801,1790,281,928,1675,5357,1788,1713,44502,12818,12818,84.1,4.0,0.6,1.4,1.7,8.1,84.1,4.0,0.6,2.1,3.7,11.9,4.0,3.8,98.5,28.4,28.4
NORTH DOWN,42376,42274,11714,29695,41,76,91,657,41409,29695,41,117,208,865,25895,310,42255,0,0,27.6,70.1,0.1,0.2,0.2,1.6,27.6,70.1,0.1,0.3,0.5,2.0,61.1,0.7,99.7,0.0,0.0
NORTH DURHAM,43811,43800,33048,7764,7,94,408,2479,40812,7764,7,101,509,2988,2773,800,43115,0,0,75.4,17.7,0.0,0.2,0.9,5.7,75.4,17.7,0.0,0.2,1.2,6.8,6.3,1.8,98.4,0.0,0.0
NORTH EAST BEDFORDSHIRE,52442,52427,24887,24334,138,604,368,2096,49221,24334,138,742,1110,3206,2983,1168,51511,0,0,47.5,46.4,0.3,1.2,0.7,4.0,47.5,46.4,0.3,1.4,2.1,6.1,5.7,2.2,98.2,0.0,0.0
NORTH EAST CAMBRIDGESHIRE,55489,55463,24548,27242,339,475,477,2382,51790,27242,339,814,1291,3673,12849,1344,54639,6381,3768,44.2,49.1,0.6,0.9,0.9,4.3,44.2,49.1,0.6,1.5,2.3,6.6,23.2,2.4,98.5,11.5,6.8
NORTH EAST DERBYSHIRE,44067,44051,32249,7616,184,480,372,3150,39865,7616,184,664,1036,4186,6407,1089,43622,0,0,73.2,17.3,0.4,1.1,0.8,7.1,73.2,17.3,0.4,1.5,2.4,9.5,14.5,2.5,99.0,0.0,0.0
NORTH EAST FIFE,42686,42572,34983,3197,232,589,991,2580,38180,3197,232,821,1812,4392,867,1987,41494,0,0,82.0,7.5,0.5,1.4,2.3,6.0,82.0,7.5,0.5,1.9,4.2,10.3,2.0,4.7,97.2,0.0,0.0
NORTH EAST HAMPSHIRE,46584,46363,19890,23267,96,495,370,2245,43157,23267,96,591,961,3206,3685,1207,45729,0,0,42.7,49.9,0.2,1.1,0.8,4.8,42.7,49.9,0.2,1.3,2.1,6.9,7.9,2.6,98.2,0.0,0.0
NORTH EAST HERTFORDSHIRE,45619,45592,15923,26062,93,423,675,2416,41985,26062,93,516,1191,3607,1175,1357,43685,0,0,34.9,57.1,0.2,0.9,1.5,5.3,34.9,57.1,0.2,1.1,2.6,7.9,2.6,3.0,95.8,0.0,0.0
NORTH EAST SOMERSET,42728,42677,24983,10962,221,371,890,5250,35945,10962,221,592,1482,6732,3303,1724,39265,0,0,58.5,25.7,0.5,0.9,2.1,12.3,58.5,25.7,0.5,1.4,3.5,15.8,7.7,4.0,91.9,0.0,0.0
NORTH HEREFORDSHIRE,42229,42187,25170,8244,502,1458,1527,5286,33414,8244,502,1960,3487,8773,7706,3677,38723,10899,3952,59.6,19.5,1.2,3.5,3.6,12.5,59.6,19.5,1.2,4.6,8.3,20.8,18.2,8.7,91.7,25.8,9.4
NORTH NORFOLK,50494,50437,42946,1225,282,961,889,4134,44171,1225,282,1243,2132,6266,1219,2232,48580,0,0,85.1,2.4,0.6,1.9,1.8,8.2,85.1,2.4,0.6,2.5,4.2,12.4,2.4,4.4,96.2,0.0,0.0
NORTH SHROPSHIRE,50872,50797,41272,3343,415,808,1185,3774,44615,3343,415,1223,2408,6182,1486,2544,49866,18838,4866,81.1,6.6,0.8,1.6,2.3,7.4,81.1,6.6,0.8,2.4,4.7,12.2,2.9,5.0,98.0,37.0,9.6
NORTH SOMERSET,48427,48257,22202,21508,251,506,666,3124,43710,21508,251,757,1423,4547,1672,1654,46143,0,0,45.8,44.4,0.5,1.0,1.4,6.5,45.8,44.4,0.5,1.6,2.9,9.4,3.5,3.4,95.3,0.0,0.0
NORTH SWINDON,52238,52236,11844,36905,15,532,564,2376,48749,36905,15,547,1111,3487,4735,1255,49088,0,0,22.7,70.6,0.0,1.0,1.1,4.5,22.7,70.6,0.0,1.0,2.1,6.7,9.1,2.4,94.0,0.0,0.0
NORTH THANET,48776,48727,31646,14703,17,127,606,1628,46349,14703,17,144,750,2378,14696,799,48425,0,0,64.9,30.1,0.0,0.3,1.2,3.3,64.9,30.1,0.0,0.3,1.5,4.9,30.1,1.6,99.3,0.0,0.0
NORTH TYNESIDE,53294,53195,29526,22475,0,66,270,858,52001,22475,0,66,336,1194,421,467,52778,0,0,55.4,42.2,0.0,0.1,0.5,1.6,55.4,42.2,0.0,0.1,0.6,2.2,0.8,0.9,99.0,0.0,0.0
NORTH WARWICKSHIRE,43002,42968,22754,18703,80,186,193,1052,41457,18703,80,266,459,1511,2394,511,42727,0,0,52.9,43.5,0.2,0.4,0.4,2.4,52.9,43.5,0.2,0.6,1.1,3.5,5.6,1.2,99.4,0.0,0.0
NORTH WEST CAMBRIDGESHIRE,62636,62327,33044,26252,202,358,308,2163,59296,26252,202,560,868,3031,6931,1240,61621,316,0,52.8,41.9,0.3,0.6,0.5,3.5,52.8,41.9,0.3,0.9,1.4,4.8,11.1,2.0,98.4,0.5,0.0
NORTH WEST DURHAM,47127,47114,41453,2054,287,306,276,2738,43507,2054,287,593,869,3607,862,890,46864,0,0,88.0,4.4,0.6,0.6,0.6,5.8,88.0,4.4,0.6,1.3,1.8,7.7,1.8,1.9,99.4,0.0,0.0
NORTH WEST HAMPSHIRE,49960,49931,23071,22807,296,526,793,2438,45878,22807,296,822,1615,4053,8159,1722,48552,0,0,46.2,45.7,0.6,1.1,1.6,4.9,46.2,45.7,0.6,1.6,3.2,8.1,16.3,3.4,97.2,0.0,0.0
NORTH WEST LEICESTERSHIRE,47713,47680,14273,31160,65,333,276,1573,45433,31160,65,398,674,2247,1772,737,47222,0,0,29.9,65.3,0.1,0.7,0.6,3.3,29.9,65.3,0.1,0.8,1.4,4.7,3.7,1.5,99.0,0.0,0.0
NORTH WEST NORFOLK,52739,52639,45379,2957,123,411,597,3172,48336,2957,123,534,1131,4303,1181,1284,51577,0,0,86.0,5.6,0.2,0.8,1.1,6.0,86.0,5.6,0.2,1.0,2.1,8.2,2.2,2.4,97.8,0.0,0.0
NORTH WILTSHIRE,43313,43285,29230,9014,298,667,1182,2894,38244,9014,298,965,2147,5041,3672,2211,42453,0,0,67.5,20.8,0.7,1.5,2.7,6.7,67.5,20.8,0.7,2.2,5.0,11.6,8.5,5.1,98.0,0.0,0.0
NORWICH NORTH,40705,40688,6160,34149,2,7,78,292,40309,34149,2,9,87,379,449,130,40566,0,0,15.1,83.9,0.0,0.0,0.2,0.7,15.1,83.9,0.0,0.0,0.2,0.9,1.1,0.3,99.7,0.0,0.0
NORWICH SOUTH,44084,43608,8112,34700,0,6,266,524,42812,34700,0,6,272,796,100,748,42897,0,0,18.4,78.7,0.0,0.0,0.6,1.2,18.4,78.7,0.0,0.0,0.6,1.8,0.2,1.7,97.3,0.0,0.0
NOTTINGHAM EAST,51058,51054,4720,44578,0,0,1,1755,49298,44578,0,0,1,1756,4975,7,49394,0,0,9.2,87.3,0.0,0.0,0.0,3.4,9.2,87.3,0.0,0.0,0.0,3.4,9.7,0.0,96.7,0.0,0.0
NOTTINGHAM NORTH,45256,45235,2503,42526,1,36,14,155,45029,42526,1,37,51,206,736,74,45165,0,0,5.5,94.0,0.0,0.1,0.0,0.3,5.5,94.0,0.0,0.1,0.1,0.5,1.6,0.2,99.8,0.0,0.0
NOTTINGHAM SOUTH,52347,52331,6272,43650,11,273,271,1854,49922,43650,11,284,555,2409,4298,686,49942,0,0,12.0,83.4,0.0,0.5,0.5,3.5,12.0,83.4,0.0,0.5,1.1,4.6,8.2,1.3,95.4,0.0,0.0
NUNEATON,44565,44562,14466,29487,40,107,30,432,43953,29487,40,147,177,609,1761,183,44396,0,0,32.5,66.2,0.1,0.2,0.1,1.0,32.5,66.2,0.1,0.3,0.4,1.4,4.0,0.4,99.6,0.0,0.0
OCHIL AND SOUTH PERTHSHIRE,50790,50661,42047,1930,667,949,1226,3842,43977,1930,667,1616,2842,6684,687,3103,48998,0,0,82.8,3.8,1.3,1.9,2.4,7.6,82.8,3.8,1.3,3.2,5.6,13.2,1.4,6.1,96.5,0.0,0.0
OGMORE,36098,36069,30125,4287,51,43,211,1352,34412,4287,51,94,305,1657,1989,343,35850,7190,4081,83.5,11.9,0.1,0.1,0.6,3.7,83.5,11.9,0.1,0.3,0.8,4.6,5.5,1.0,99.3,19.9,11.3
OLD BEXLEY AND SIDCUP,38295,38280,13649,23564,3,8,85,971,37213,23564,3,11,96,1067,3234,121,37791,0,0,35.6,61.5,0.0,0.0,0.2,2.5,35.6,61.5,0.0,0.0,0.3,2.8,8.4,0.3,98.7,0.0,0.0
OLDHAM EAST AND SADDLEWORTH,45177,45141,15996,27603,69,127,78,1268,43599,27603,69,196,274,1542,1397,320,44962,0,0,35.4,61.1,0.2,0.3,0.2,2.8,35.4,61.1,0.2,0.4,0.6,3.4,3.1,0.7,99.5,0.0,0.0
OLDHAM WEST AND ROYTON,43269,43245,7237,35774,0,1,92,141,43011,35774,0,1,93,234,1564,117,43138,0,0,16.7,82.7,0.0,0.0,0.2,0.3,16.7,82.7,0.0,0.0,0.2,0.5,3.6,0.3,99.7,0.0,0.0
ORKNEY AND SHETLAND,23725,22888,15368,98,918,1220,2530,2754,15466,98,918,2138,4668,7422,98,5587,18792,0,0,64.8,0.4,3.9,5.1,10.7,11.6,64.8,0.4,3.9,9.0,19.7,31.3,0.4,23.5,79.2,0.0,0.0
ORPINGTON,40068,40060,6328,31742,54,294,341,1301,38070,31742,54,348,689,1990,277,765,38861,0,0,15.8,79.2,0.1,0.7,0.9,3.2,15.8,79.2,0.1,0.9,1.7,5.0,0.7,1.9,97.0,0.0,0.0
OXFORD EAST,52248,52201,9885,40745,0,29,218,1324,50630,40745,0,29,247,1571,1192,365,50725,0,0,18.9,78.0,0.0,0.1,0.4,2.5,18.9,78.0,0.0,0.1,0.5,3.0,2.3,0.7,97.1,0.0,0.0
OXFORD WEST AND ABINGDON,49389,49342,9804,38591,17,29,61,840,48395,38591,17,46,107,947,2722,188,48782,0,0,19.9,78.1,0.0,0.1,0.1,1.7,19.9,78.1,0.0,0.1,0.2,1.9,5.5,0.4,98.8,0.0,0.0
PAISLEY AND RENFREWSHIRE NORTH,46854,46834,10251,34707,28,100,157,1591,44958,34707,28,128,285,1876,7101,556,45936,0,0,21.9,74.1,0.1,0.2,0.3,3.4,21.9,74.1,0.1,0.3,0.6,4.0,15.2,1.2,98.0,0.0,0.0
PAISLEY AND RENFREWSHIRE SOUTH,47206,47199,12509,33492,63,105,186,844,46001,33492,63,168,354,1198,1694,369,46581,0,0,26.5,70.9,0.1,0.2,0.4,1.8,26.5,70.9,0.1,0.4,0.7,2.5,3.6,0.8,98.7,0.0,0.0
PENDLE,43503,43482,27482,14435,121,158,154,1132,41917,14435,121,279,433,1565,619,466,43177,25020,9290,63.2,33.2,0.3,0.4,0.4,2.6,63.2,33.2,0.3,0.6,1.0,3.6,1.4,1.1,99.3,57.5,21.4
PENISTONE AND STOCKSBRIDGE,42276,42261,33133,3993,135,130,605,4265,37126,3993,135,265,870,5135,1345,1190,39002,0,0,78.4,9.4,0.3,0.3,1.4,10.1,78.4,9.4,0.3,0.6,2.1,12.1,3.2,2.8,92.3,0.0,0.0
PENRITH AND THE BORDER,44851,44664,33496,2452,1833,1652,1540,3691,35948,2452,1833,3485,5025,8716,1611,5345,42409,1454,1283,74.7,5.5,4.1,3.7,3.4,8.2,74.7,5.5,4.1,7.8,11.2,19.4,3.6,11.9,94.6,3.2,2.9
PERTH AND NORTH PERTHSHIRE,52628,52358,21381,24262,680,1057,1448,3530,45643,24262,680,1737,3185,6715,682,3587,50172,0,0,40.6,46.1,1.3,2.0,2.8,6.7,40.6,46.1,1.3,3.3,6.1,12.8,1.3,6.8,95.3,0.0,0.0
PETERBOROUGH,54913,54871,9188,44421,49,152,158,903,53609,44421,49,201,359,1262,17134,401,54283,0,0,16.7,80.9,0.1,0.3,0.3,1.6,16.7,80.9,0.1,0.4,0.7,2.3,31.2,0.7,98.9,0.0,0.0
"PLYMOUTH, MOOR VIEW",43720,43715,5337,37611,2,67,190,508,42948,37611,2,69,259,767,665,294,43289,12825,3211,12.2,86.0,0.0,0.2,0.4,1.2,12.2,86.0,0.0,0.2,0.6,1.8,1.5,0.7,99.0,29.3,7.3
"PLYMOUTH, SUTTON AND DEVONPORT",55633,55604,8026,45002,0,39,636,1901,53028,45002,0,39,675,2576,16,840,53060,9075,372,14.4,80.9,0.0,0.1,1.1,3.4,14.4,80.9,0.0,0.1,1.2,4.6,0.0,1.5,95.4,16.3,0.7
PONTYPRIDD,39360,39349,25354,12476,26,17,275,1201,37830,12476,26,43,318,1519,1937,432,38788,14204,11148,64.4,31.7,0.1,0.0,0.7,3.1,64.4,31.7,0.1,0.1,0.8,3.9,4.9,1.1,98.5,36.1,28.3
POOLE,51378,51344,13598,36906,0,1,36,803,50504,36906,0,1,37,840,321,105,50749,0,0,26.5,71.8,0.0,0.0,0.1,1.6,26.5,71.8,0.0,0.0,0.1,1.6,0.6,0.2,98.8,0.0,0.0
POPLAR AND LIMEHOUSE,75496,75419,21292,48559,0,33,496,5039,69851,48559,0,33,529,5568,32982,665,69869,0,0,28.2,64.3,0.0,0.0,0.7,6.7,28.2,64.3,0.0,0.0,0.7,7.4,43.7,0.9,92.5,0.0,0.0
PORTSMOUTH NORTH ,44138,44131,4688,38667,1,102,212,461,43355,38667,1,103,315,776,2429,505,43368,0,0,10.6,87.6,0.0,0.2,0.5,1.0,10.6,87.6,0.0,0.2,0.7,1.8,5.5,1.1,98.3,0.0,0.0
PORTSMOUTH SOUTH,52143,51750,4424,44934,0,190,196,2006,49358,44934,0,190,386,2392,1732,807,49502,0,0,8.5,86.2,0.0,0.4,0.4,3.8,8.5,86.2,0.0,0.4,0.7,4.6,3.3,1.5,94.9,0.0,0.0
PRESELI PEMBROKESHIRE,40255,40186,31879,2194,954,1240,1290,2629,34073,2194,954,2194,3484,6113,2194,3703,38052,3235,1324,79.2,5.5,2.4,3.1,3.2,6.5,79.2,5.5,2.4,5.5,8.7,15.2,5.5,9.2,94.5,8.0,3.3
PRESTON,46569,46533,14966,30679,0,3,108,777,45645,30679,0,3,111,888,484,148,45944,31324,28557,32.1,65.9,0.0,0.0,0.2,1.7,32.1,65.9,0.0,0.0,0.2,1.9,1.0,0.3,98.7,67.3,61.3
PUDSEY,44430,44429,10592,33177,6,10,13,631,43769,33177,6,16,29,660,762,114,44180,8872,1319,23.8,74.7,0.0,0.0,0.0,1.4,23.8,74.7,0.0,0.0,0.1,1.5,1.7,0.3,99.4,20.0,3.0
PUTNEY,45605,45573,13282,30864,0,15,45,1367,44146,30864,0,15,60,1427,12091,111,44163,0,0,29.1,67.7,0.0,0.0,0.1,3.0,29.1,67.7,0.0,0.0,0.1,3.1,26.5,0.2,96.8,0.0,0.0
RAYLEIGH AND WICKFORD,43998,43967,31090,11212,1,36,139,1489,42302,11212,1,37,176,1665,2235,212,43693,0,0,70.7,25.5,0.0,0.1,0.3,3.4,70.7,25.5,0.0,0.1,0.4,3.8,5.1,0.5,99.3,0.0,0.0
READING EAST,52126,52079,14096,37048,0,6,41,888,51144,37048,0,6,47,935,4219,166,51275,0,0,27.0,71.1,0.0,0.0,0.1,1.7,27.0,71.1,0.0,0.0,0.1,1.8,8.1,0.3,98.4,0.0,0.0
READING WEST,48796,48771,15069,32812,5,101,94,690,47881,32812,5,106,200,890,4127,301,48218,0,0,30.9,67.2,0.0,0.2,0.2,1.4,30.9,67.2,0.0,0.2,0.4,1.8,8.5,0.6,98.8,0.0,0.0
REDCAR,43211,43202,3309,38999,86,139,230,439,42308,38999,86,225,455,894,126,633,42456,259,0,7.7,90.3,0.2,0.3,0.5,1.0,7.7,90.3,0.2,0.5,1.1,2.1,0.3,1.5,98.3,0.6,0.0
REDDITCH,42192,42164,10102,30646,39,89,157,1131,40748,30646,39,128,285,1416,774,322,41608,1472,837,23.9,72.6,0.1,0.2,0.4,2.7,23.9,72.6,0.1,0.3,0.7,3.4,1.8,0.8,98.6,3.5,2.0
REIGATE,45844,45832,15266,29192,15,69,95,1195,44458,29192,15,84,179,1374,831,203,45689,0,0,33.3,63.7,0.0,0.2,0.2,2.6,33.3,63.7,0.0,0.2,0.4,3.0,1.8,0.4,99.7,0.0,0.0
RHONDDA,35801,35756,35357,58,1,4,1,335,35415,58,1,5,6,341,58,51,35742,2499,0,98.8,0.2,0.0,0.0,0.0,0.9,98.8,0.2,0.0,0.0,0.0,1.0,0.2,0.1,99.8,7.0,0.0
RIBBLE VALLEY,48940,48903,30089,15013,230,530,614,2427,45102,15013,230,760,1374,3801,2596,1429,48449,26292,9528,61.5,30.7,0.5,1.1,1.3,5.0,61.5,30.7,0.5,1.6,2.8,7.8,5.3,2.9,99.0,53.7,19.5
RICHMOND PARK,54450,54410,10833,42117,0,15,131,1314,52950,42117,0,15,146,1460,1922,193,53446,0,0,19.9,77.3,0.0,0.0,0.2,2.4,19.9,77.3,0.0,0.0,0.3,2.7,3.5,0.4,98.2,0.0,0.0
RICHMOND (YORKS),52584,52441,41779,2843,1112,1388,1671,3648,44622,2843,1112,2500,4171,7819,1135,4379,50950,20728,13596,79.5,5.4,2.1,2.6,3.2,6.9,79.5,5.4,2.1,4.8,7.9,14.9,2.2,8.3,96.9,39.4,25.9
ROCHDALE,49621,49560,17881,30856,5,43,155,620,48737,30856,5,48,203,823,8042,281,49432,0,0,36.0,62.2,0.0,0.1,0.3,1.2,36.0,62.2,0.0,0.1,0.4,1.7,16.2,0.6,99.6,0.0,0.0
ROCHESTER AND STROOD,51195,51164,18149,30466,24,213,435,1877,48615,30466,24,237,672,2549,614,744,50138,0,0,35.5,59.5,0.0,0.4,0.8,3.7,35.5,59.5,0.0,0.5,1.3,5.0,1.2,1.5,97.9,0.0,0.0
ROCHFORD AND SOUTHEND EAST,51195,51093,14563,34168,7,22,185,2148,48731,34168,7,29,214,2362,1541,619,49356,0,0,28.4,66.7,0.0,0.0,0.4,4.2,28.4,66.7,0.0,0.1,0.4,4.6,3.0,1.2,96.4,0.0,0.0
ROMFORD,45605,45350,7395,36888,8,2,108,949,44283,36888,8,10,118,1067,1983,376,44412,0,0,16.2,80.9,0.0,0.0,0.2,2.1,16.2,80.9,0.0,0.0,0.3,2.3,4.3,0.8,97.4,0.0,0.0
ROMSEY AND SOUTHAMPTON NORTH,40193,40169,12354,24269,167,341,639,2399,36623,24269,167,508,1147,3546,2446,1185,39430,0,0,30.7,60.4,0.4,0.8,1.6,6.0,30.7,60.4,0.4,1.3,2.9,8.8,6.1,2.9,98.1,0.0,0.0
ROSSENDALE AND DARWEN,48483,48456,25341,20865,42,309,204,1695,46206,20865,42,351,555,2250,2003,587,48115,11266,9330,52.3,43.0,0.1,0.6,0.4,3.5,52.3,43.0,0.1,0.7,1.1,4.6,4.1,1.2,99.2,23.2,19.2
"ROSS, SKYE AND LOCHABER",32813,31649,23771,413,1133,1090,1716,3526,24184,413,1133,2223,3939,7465,413,5192,29063,4984,1223,72.4,1.3,3.5,3.3,5.2,10.7,72.4,1.3,3.5,6.8,12.0,22.8,1.3,15.8,88.6,15.2,3.7
ROTHERHAM,42681,42651,8689,33341,0,36,43,542,42030,33341,0,36,79,621,1100,147,42397,0,0,20.4,78.1,0.0,0.1,0.1,1.3,20.4,78.1,0.0,0.1,0.2,1.5,2.6,0.3,99.3,0.0,0.0
ROTHER VALLEY,45199,45076,26016,17976,43,59,146,836,43992,17976,43,102,248,1084,3963,373,44882,525,214,57.6,39.8,0.1,0.1,0.3,1.8,57.6,39.8,0.1,0.2,0.5,2.4,8.8,0.8,99.3,1.2,0.5
RUGBY,48094,48060,18200,27867,128,95,373,1397,46067,27867,128,223,596,1993,1866,712,47046,0,0,37.8,57.9,0.3,0.2,0.8,2.9,37.8,57.9,0.3,0.5,1.2,4.1,3.9,1.5,97.8,0.0,0.0
"RUISLIP, NORTHWOOD AND PINNER",42538,42500,10598,31008,14,32,144,704,41606,31008,14,46,190,894,791,450,41833,0,0,24.9,72.9,0.0,0.1,0.3,1.7,24.9,72.9,0.0,0.1,0.4,2.1,1.9,1.1,98.3,0.0,0.0
RUNNYMEDE AND WEYBRIDGE,49128,49092,15693,32102,8,20,223,1046,47795,32102,8,28,251,1297,1821,289,48780,0,0,31.9,65.3,0.0,0.0,0.5,2.1,31.9,65.3,0.0,0.1,0.5,2.6,3.7,0.6,99.3,0.0,0.0
RUSHCLIFFE,45951,45917,12284,32156,67,101,192,1117,44440,32156,67,168,360,1477,1770,407,45691,387,1,26.7,70.0,0.1,0.2,0.4,2.4,26.7,70.0,0.1,0.4,0.8,3.2,3.9,0.9,99.4,0.8,0.0
RUTHERGLEN AND HAMILTON WEST,51956,51943,13741,37157,33,33,253,726,50898,37157,33,66,319,1045,1070,339,51478,0,0,26.4,71.5,0.1,0.1,0.5,1.4,26.4,71.5,0.1,0.1,0.6,2.0,2.1,0.7,99.1,0.0,0.0
RUTLAND AND MELTON,49274,49209,31035,14436,319,448,579,2392,45471,14436,319,767,1346,3738,3025,1483,48214,592,328,63.0,29.3,0.6,0.9,1.2,4.9,63.0,29.3,0.6,1.6,2.7,7.6,6.1,3.0,97.8,1.2,0.7
SAFFRON WALDEN,51323,51263,32144,11316,289,863,1835,4816,43460,11316,289,1152,2987,7803,4519,3256,47314,0,0,62.6,22.0,0.6,1.7,3.6,9.4,62.6,22.0,0.6,2.2,5.8,15.2,8.8,6.3,92.2,0.0,0.0
SALFORD AND ECCLES,64527,64496,11077,49446,1,249,1525,2198,60523,49446,1,250,1775,3973,33577,2166,60605,1498,0,17.2,76.6,0.0,0.4,2.4,3.4,17.2,76.6,0.0,0.4,2.8,6.2,52.0,3.4,93.9,2.3,0.0
SALISBURY,46559,46539,18698,25736,84,154,259,1608,44434,25736,84,238,497,2105,7488,532,46243,47,47,40.2,55.3,0.2,0.3,0.6,3.5,40.2,55.3,0.2,0.5,1.1,4.5,16.1,1.1,99.3,0.1,0.1
SCARBOROUGH AND WHITBY,55420,55381,50126,1016,366,411,341,3121,51142,1016,366,777,1118,4239,1013,1266,53745,1033,0,90.4,1.8,0.7,0.7,0.6,5.6,90.4,1.8,0.7,1.4,2.0,7.6,1.8,2.3,97.0,1.9,0.0
SCUNTHORPE,42268,42224,11477,29775,152,186,172,462,41252,29775,152,338,510,972,252,566,41820,22301,18434,27.2,70.4,0.4,0.4,0.4,1.1,27.2,70.4,0.4,0.8,1.2,2.3,0.6,1.3,98.9,52.8,43.6
SEDGEFIELD,41879,41848,32650,4304,366,540,666,3322,36954,4304,366,906,1572,4894,837,1656,39929,1819,578,78.0,10.3,0.9,1.3,1.6,7.9,78.0,10.3,0.9,2.2,3.8,11.7,2.0,4.0,95.3,4.3,1.4
SEFTON CENTRAL,38858,38769,9284,28393,46,60,113,873,37677,28393,46,106,219,1092,1528,308,38617,31,0,23.9,73.1,0.1,0.2,0.3,2.2,23.9,73.1,0.1,0.3,0.6,2.8,3.9,0.8,99.4,0.1,0.0
SELBY AND AINSTY,48090,48031,37259,4553,509,673,552,4485,41812,4553,509,1182,1734,6219,4444,1879,46522,8568,7499,77.5,9.5,1.1,1.4,1.1,9.3,77.5,9.5,1.1,2.5,3.6,12.9,9.2,3.9,96.7,17.8,15.6
SEVENOAKS,43123,43108,29139,10826,63,127,328,2625,39965,10826,63,190,518,3143,935,536,42931,0,0,67.6,25.1,0.1,0.3,0.8,6.1,67.6,25.1,0.1,0.4,1.2,7.3,2.2,1.2,99.6,0.0,0.0
"SHEFFIELD, BRIGHTSIDE AND HILLSBOROUGH",48647,48640,12223,35799,0,27,244,347,48022,35799,0,27,271,618,168,313,48292,0,0,25.1,73.6,0.0,0.1,0.5,0.7,25.1,73.6,0.0,0.1,0.6,1.3,0.3,0.6,99.3,0.0,0.0
SHEFFIELD CENTRAL,63836,63814,17903,36752,1,19,551,8588,54655,36752,1,20,571,9159,4234,920,54730,0,0,28.0,57.6,0.0,0.0,0.9,13.5,28.0,57.6,0.0,0.0,0.9,14.3,6.6,1.4,85.7,0.0,0.0
"SHEFFIELD, HALLAM",41548,41544,32671,7142,42,40,44,1605,39813,7142,42,82,126,1731,285,164,41415,0,0,78.6,17.2,0.1,0.1,0.1,3.9,78.6,17.2,0.1,0.2,0.3,4.2,0.7,0.4,99.7,0.0,0.0
"SHEFFIELD, HEELEY",45239,45236,20936,23436,0,0,4,860,44372,23436,0,0,4,864,112,38,45055,0,0,46.3,51.8,0.0,0.0,0.0,1.9,46.3,51.8,0.0,0.0,0.0,1.9,0.2,0.1,99.6,0.0,0.0
SHEFFIELD SOUTH EAST,44517,44502,29165,14047,2,68,121,1099,43212,14047,2,70,191,1290,965,245,43877,0,0,65.5,31.6,0.0,0.2,0.3,2.5,65.5,31.6,0.0,0.2,0.4,2.9,2.2,0.6,98.6,0.0,0.0
SHERWOOD,47548,47533,14048,32112,52,148,122,1051,46160,32112,52,200,322,1373,5224,340,47347,0,0,29.5,67.5,0.1,0.3,0.3,2.2,29.5,67.5,0.1,0.4,0.7,2.9,11.0,0.7,99.6,0.0,0.0
SHIPLEY,43725,43716,17112,25159,42,103,129,1171,42271,25159,42,145,274,1445,2770,308,43225,20984,9136,39.1,57.5,0.1,0.2,0.3,2.7,39.1,57.5,0.1,0.3,0.6,3.3,6.3,0.7,98.9,48.0,20.9
SHREWSBURY AND ATCHAM,51533,51416,37683,7609,249,654,836,4385,45292,7609,249,903,1739,6124,3640,2033,48237,20630,5852,73.1,14.8,0.5,1.3,1.6,8.5,73.1,14.8,0.5,1.8,3.4,11.9,7.1,3.9,93.6,40.0,11.4
SITTINGBOURNE AND SHEPPEY,53024,52955,28163,21629,101,303,496,2263,49792,21629,101,404,900,3163,1057,991,52459,0,0,53.1,40.8,0.2,0.6,0.9,4.3,53.1,40.8,0.2,0.8,1.7,6.0,2.0,1.9,98.9,0.0,0.0
SKIPTON AND RIPON,50605,50510,38216,5350,941,1184,1176,3643,43566,5350,941,2125,3301,6944,3972,3473,48838,14960,9739,75.5,10.6,1.9,2.3,2.3,7.2,75.5,10.6,1.9,4.2,6.5,13.7,7.8,6.9,96.5,29.6,19.2
SLEAFORD AND NORTH HYKEHAM,55706,55674,37499,13812,475,522,602,2764,51311,13812,475,997,1599,4363,1594,1766,54466,1842,1266,67.3,24.8,0.9,0.9,1.1,5.0,67.3,24.8,0.9,1.8,2.9,7.8,2.9,3.2,97.8,3.3,2.3
SLOUGH,54575,54515,7898,46078,25,38,91,385,53976,46078,25,63,154,539,2616,223,54128,0,0,14.5,84.4,0.0,0.1,0.2,0.7,14.5,84.4,0.0,0.1,0.3,1.0,4.8,0.4,99.2,0.0,0.0
SOLIHULL,45140,45123,7168,37014,0,3,284,654,44182,37014,0,3,287,941,6582,370,44200,0,0,15.9,82.0,0.0,0.0,0.6,1.4,15.9,82.0,0.0,0.0,0.6,2.1,14.6,0.8,97.9,0.0,0.0
SOMERTON AND FROME,52932,52808,30627,12111,384,1776,2538,5372,42738,12111,384,2160,4698,10070,1830,5153,49463,3609,3609,57.9,22.9,0.7,3.4,4.8,10.1,57.9,22.9,0.7,4.1,8.9,19.0,3.5,9.7,93.4,6.8,6.8
"SOUTHAMPTON, ITCHEN",54443,54223,4949,46023,0,16,377,2858,50972,46023,0,16,393,3251,6459,641,51050,0,0,9.1,84.5,0.0,0.0,0.7,5.2,9.1,84.5,0.0,0.0,0.7,6.0,11.9,1.2,93.8,0.0,0.0
"SOUTHAMPTON, TEST",51357,51045,5194,44447,0,10,282,1112,49641,44447,0,10,292,1404,3053,638,49663,0,0,10.1,86.5,0.0,0.0,0.5,2.2,10.1,86.5,0.0,0.0,0.6,2.7,5.9,1.2,96.7,0.0,0.0
SOUTH ANTRIM,42387,41891,21502,14915,1029,877,656,2912,36417,14915,1029,1906,2562,5474,10506,3074,41329,0,0,50.7,35.2,2.4,2.1,1.5,6.9,50.7,35.2,2.4,4.5,6.0,12.9,24.8,7.3,97.5,0.0,0.0
SOUTH BASILDON AND EAST THURROCK,44457,44408,13576,28865,22,225,250,1470,42441,28865,22,247,497,1967,1745,574,43933,0,0,30.5,64.9,0.0,0.5,0.6,3.3,30.5,64.9,0.0,0.6,1.1,4.4,3.9,1.3,98.8,0.0,0.0
SOUTH CAMBRIDGESHIRE,52104,52082,23245,26490,88,160,317,1782,49735,26490,88,248,565,2347,8769,617,51477,190,89,44.6,50.8,0.2,0.3,0.6,3.4,44.6,50.8,0.2,0.5,1.1,4.5,16.8,1.2,98.8,0.4,0.2
SOUTH DERBYSHIRE,47802,47721,35266,8324,228,565,485,2853,43590,8324,228,793,1278,4131,3419,1429,47030,0,0,73.8,17.4,0.5,1.2,1.0,6.0,73.8,17.4,0.5,1.7,2.7,8.6,7.2,3.0,98.4,0.0,0.0
SOUTH DORSET,49471,49075,45864,685,145,177,256,1948,46549,685,145,322,578,2526,685,994,48761,0,0,92.7,1.4,0.3,0.4,0.5,3.9,92.7,1.4,0.3,0.7,1.2,5.1,1.4,2.0,98.6,0.0,0.0
SOUTH DOWN,44299,43487,31124,3652,1618,1426,1456,4211,34776,3652,1618,3044,4500,8711,3652,5388,42501,2350,27,70.3,8.2,3.7,3.2,3.3,9.5,70.3,8.2,3.7,6.9,10.2,19.7,8.2,12.2,95.9,5.3,0.1
SOUTH EAST CAMBRIDGESHIRE,53441,53391,27414,22855,180,233,624,2085,50269,22855,180,413,1037,3122,1489,1141,52791,8831,7214,51.3,42.8,0.3,0.4,1.2,3.9,51.3,42.8,0.3,0.8,1.9,5.8,2.8,2.1,98.8,16.5,13.5
SOUTH EAST CORNWALL,47875,47737,26884,16065,270,493,660,3365,42949,16065,270,763,1423,4788,9719,1673,46130,6043,2377,56.2,33.6,0.6,1.0,1.4,7.0,56.2,33.6,0.6,1.6,3.0,10.0,20.3,3.5,96.4,12.6,5.0
SOUTHEND WEST,42868,42850,22716,17841,0,2,4,2287,40557,17841,0,2,6,2293,284,24,41072,0,0,53.0,41.6,0.0,0.0,0.0,5.3,53.0,41.6,0.0,0.0,0.0,5.3,0.7,0.1,95.8,0.0,0.0
SOUTH HOLLAND AND THE DEEPINGS,49958,49900,41303,2549,189,862,816,4181,43852,2549,189,1051,1867,6048,2032,1933,49244,231,223,82.7,5.1,0.4,1.7,1.6,8.4,82.7,5.1,0.4,2.1,3.7,12.1,4.1,3.9,98.6,0.5,0.4
SOUTH LEICESTERSHIRE,48440,48423,21368,25242,88,122,114,1489,46610,25242,88,210,324,1813,18311,406,47588,0,0,44.1,52.1,0.2,0.3,0.2,3.1,44.1,52.1,0.2,0.4,0.7,3.7,37.8,0.8,98.2,0.0,0.0
SOUTH NORFOLK,51314,51282,42579,1991,241,921,1059,4491,44570,1991,241,1162,2221,6712,1164,2381,49801,0,0,83.0,3.9,0.5,1.8,2.1,8.8,83.0,3.9,0.5,2.3,4.3,13.1,2.3,4.6,97.1,0.0,0.0
SOUTH NORTHAMPTONSHIRE,54760,54494,34182,16251,80,1153,699,2129,50433,16251,80,1233,1932,4061,6077,2381,52059,318,205,62.4,29.7,0.1,2.1,1.3,3.9,62.4,29.7,0.1,2.3,3.5,7.4,11.1,4.3,95.1,0.6,0.4
SOUTHPORT,46043,46003,30899,14144,0,18,3,939,45043,14144,0,18,21,960,175,67,45853,188,0,67.1,30.7,0.0,0.0,0.0,2.0,67.1,30.7,0.0,0.0,0.0,2.1,0.4,0.1,99.6,0.4,0.0
SOUTH RIBBLE,45558,45537,21515,21436,51,182,376,1977,42951,21436,51,233,609,2586,1275,705,44884,16757,11024,47.2,47.1,0.1,0.4,0.8,4.3,47.2,47.1,0.1,0.5,1.3,5.7,2.8,1.5,98.5,36.8,24.2
SOUTH SHIELDS,42427,42426,8643,33084,16,51,59,573,41727,33084,16,67,126,699,49,213,41952,0,0,20.4,78.0,0.0,0.1,0.1,1.4,20.4,78.0,0.0,0.2,0.3,1.6,0.1,0.5,98.9,0.0,0.0
SOUTH STAFFORDSHIRE,42752,42728,25503,14412,64,191,466,2092,39915,14412,64,255,721,2813,13076,748,42439,604,15,59.7,33.7,0.1,0.4,1.1,4.9,59.7,33.7,0.1,0.6,1.7,6.6,30.6,1.7,99.3,1.4,0.0
SOUTH SUFFOLK,45209,45162,37169,4603,198,286,334,2572,41772,4603,198,484,818,3390,2844,885,44728,0,0,82.2,10.2,0.4,0.6,0.7,5.7,82.2,10.2,0.4,1.1,1.8,7.5,6.3,2.0,98.9,0.0,0.0
SOUTH SWINDON,48780,48768,4334,39620,18,287,1054,3455,43954,39620,18,305,1359,4814,3751,1776,44044,0,0,8.9,81.2,0.0,0.6,2.2,7.1,8.9,81.2,0.0,0.6,2.8,9.9,7.7,3.6,90.3,0.0,0.0
SOUTH THANET,50669,50571,31805,16756,49,145,362,1454,48561,16756,49,194,556,2010,16727,678,50151,0,0,62.8,33.1,0.1,0.3,0.7,2.9,62.8,33.1,0.1,0.4,1.1,4.0,33.0,1.3,99.0,0.0,0.0
SOUTH WEST BEDFORDSHIRE,49404,49401,14479,33785,5,16,158,958,48264,33785,5,21,179,1137,1436,287,49035,0,0,29.3,68.4,0.0,0.0,0.3,1.9,29.3,68.4,0.0,0.0,0.4,2.3,2.9,0.6,99.3,0.0,0.0
SOUTH WEST DEVON,42954,42919,9401,29530,81,377,1138,2392,38931,29530,81,458,1596,3988,5852,1821,41305,10859,6550,21.9,68.7,0.2,0.9,2.6,5.6,21.9,68.7,0.2,1.1,3.7,9.3,13.6,4.2,96.2,25.3,15.2
SOUTH WEST HERTFORDSHIRE,47726,47708,13939,31303,62,121,178,2105,45242,31303,62,183,361,2466,1244,380,47309,0,0,29.2,65.6,0.1,0.3,0.4,4.4,29.2,65.6,0.1,0.4,0.8,5.2,2.6,0.8,99.1,0.0,0.0
SOUTH WEST NORFOLK,51840,51706,43043,2534,519,688,1040,3882,45577,2534,519,1207,2247,6129,1157,2467,50646,2399,325,83.0,4.9,1.0,1.3,2.0,7.5,83.0,4.9,1.0,2.3,4.3,11.8,2.2,4.8,97.7,4.6,0.6
SOUTH WEST SURREY,47320,47291,38662,5973,37,72,121,2426,44635,5973,37,109,230,2656,1449,261,47131,0,0,81.7,12.6,0.1,0.2,0.3,5.1,81.7,12.6,0.1,0.2,0.5,5.6,3.1,0.6,99.6,0.0,0.0
SOUTH WEST WILTSHIRE,49184,49149,19982,25891,256,291,351,2378,45873,25891,256,547,898,3276,1584,959,48312,2278,2278,40.6,52.6,0.5,0.6,0.7,4.8,40.6,52.6,0.5,1.1,1.8,6.7,3.2,1.9,98.2,4.6,4.6
SPELTHORNE,44362,44341,7044,36329,0,4,167,797,43373,36329,0,4,171,968,11747,276,43700,0,0,15.9,81.9,0.0,0.0,0.4,1.8,15.9,81.9,0.0,0.0,0.4,2.2,26.5,0.6,98.5,0.0,0.0
STAFFORD,46703,46671,13128,30941,68,200,848,1486,44069,30941,68,268,1116,2602,1212,1191,45478,122,0,28.1,66.3,0.1,0.4,1.8,3.2,28.1,66.3,0.1,0.6,2.4,5.6,2.6,2.6,97.4,0.3,0.0
STAFFORDSHIRE MOORLANDS,37288,37270,21868,11834,319,470,840,1939,33702,11834,319,789,1629,3568,661,1735,36540,0,0,58.6,31.7,0.9,1.3,2.3,5.2,58.6,31.7,0.9,2.1,4.4,9.6,1.8,4.7,98.0,0.0,0.0
ST ALBANS,45421,45414,8770,35153,1,21,28,1441,43923,35153,1,22,50,1491,945,73,44849,0,0,19.3,77.4,0.0,0.0,0.1,3.2,19.3,77.4,0.0,0.0,0.1,3.3,2.1,0.2,98.7,0.0,0.0
STALYBRIDGE AND HYDE,48070,47926,35462,10060,2,11,112,2279,45522,10060,2,13,125,2404,5768,270,47848,0,0,73.8,20.9,0.0,0.0,0.2,4.7,73.8,20.9,0.0,0.0,0.3,5.0,12.0,0.6,99.5,0.0,0.0
ST AUSTELL AND NEWQUAY,53906,53805,32843,16889,96,339,275,3363,49732,16889,96,435,710,4073,14557,927,52196,0,0,60.9,31.3,0.2,0.6,0.5,6.2,60.9,31.3,0.2,0.8,1.3,7.6,27.0,1.7,96.8,0.0,0.0
STEVENAGE,44098,44067,7501,35900,0,34,74,558,43401,35900,0,34,108,666,523,164,43762,0,0,17.0,81.4,0.0,0.1,0.2,1.3,17.0,81.4,0.0,0.1,0.2,1.5,1.2,0.4,99.2,0.0,0.0
ST HELENS NORTH,46775,46768,7183,38277,88,114,194,912,45460,38277,88,202,396,1308,483,498,46378,5103,752,15.4,81.8,0.2,0.2,0.4,1.9,15.4,81.8,0.2,0.4,0.8,2.8,1.0,1.1,99.2,10.9,1.6
ST HELENS SOUTH AND WHISTON,51091,51079,11366,38692,24,156,204,637,50058,38692,24,180,384,1021,1046,418,50501,10148,0,22.2,75.7,0.0,0.3,0.4,1.2,22.2,75.7,0.0,0.4,0.8,2.0,2.0,0.8,98.8,19.9,0.0
STIRLING,44269,44172,29076,9677,712,781,950,2976,38753,9677,712,1493,2443,5419,7632,2588,42558,0,0,65.7,21.9,1.6,1.8,2.1,6.7,65.7,21.9,1.6,3.4,5.5,12.2,17.2,5.8,96.1,0.0,0.0
ST IVES,50227,50059,27412,18045,124,297,652,3529,45457,18045,124,421,1073,4602,18045,1350,48428,0,0,54.6,35.9,0.2,0.6,1.3,7.0,54.6,35.9,0.2,0.8,2.1,9.2,35.9,2.7,96.4,0.0,0.0
STOCKPORT,44109,44089,6428,37290,1,3,0,367,43718,37290,1,4,4,371,295,40,43754,3575,0,14.6,84.5,0.0,0.0,0.0,0.8,14.6,84.5,0.0,0.0,0.0,0.8,0.7,0.1,99.2,8.1,0.0
STOCKTON NORTH,44025,44007,7704,34147,62,229,459,1406,41851,34147,62,291,750,2156,848,866,42423,4168,423,17.5,77.6,0.1,0.5,1.0,3.2,17.5,77.6,0.1,0.7,1.7,4.9,1.9,2.0,96.4,9.5,1.0
STOCKTON SOUTH,46772,46761,13620,30903,20,327,634,1257,44523,30903,20,347,981,2238,1600,1288,44591,6746,1592,29.1,66.1,0.0,0.7,1.4,2.7,29.1,66.1,0.0,0.7,2.1,4.8,3.4,2.8,95.3,14.4,3.4
STOKE-ON-TRENT CENTRAL,43819,43799,9210,33311,2,18,100,1158,42521,33311,2,20,120,1278,161,201,42587,0,0,21.0,76.0,0.0,0.0,0.2,2.6,21.0,76.0,0.0,0.0,0.3,2.9,0.4,0.5,97.2,0.0,0.0
STOKE-ON-TRENT NORTH,47732,47721,10436,36551,0,7,216,511,46987,36551,0,7,223,734,2827,287,47240,0,0,21.9,76.6,0.0,0.0,0.5,1.1,21.9,76.6,0.0,0.0,0.5,1.5,5.9,0.6,99.0,0.0,0.0
STOKE-ON-TRENT SOUTH,42482,42477,16342,24998,0,42,55,1040,41340,24998,0,42,97,1137,215,115,42293,0,0,38.5,58.8,0.0,0.1,0.1,2.4,38.5,58.8,0.0,0.1,0.2,2.7,0.5,0.3,99.6,0.0,0.0
STONE,41008,40974,27478,8928,158,565,876,2969,36406,8928,158,723,1599,4568,1896,1689,39967,1124,241,67.0,21.8,0.4,1.4,2.1,7.2,67.0,21.8,0.4,1.8,3.9,11.1,4.6,4.1,97.5,2.7,0.6
STOURBRIDGE,41513,41489,4231,36867,0,5,14,372,41098,36867,0,5,19,391,218,43,41439,0,0,10.2,88.8,0.0,0.0,0.0,0.9,10.2,88.8,0.0,0.0,0.0,0.9,0.5,0.1,99.8,0.0,0.0
STRANGFORD,40017,39785,19282,16106,458,665,955,2319,35388,16106,458,1123,2078,4397,16106,2321,39663,0,0,48.2,40.2,1.1,1.7,2.4,5.8,48.2,40.2,1.1,2.8,5.2,11.0,40.2,5.8,99.1,0.0,0.0
STRATFORD-ON-AVON,47475,47367,29318,14615,180,434,666,2154,43933,14615,180,614,1280,3434,2880,1425,46495,2969,546,61.8,30.8,0.4,0.9,1.4,4.5,61.8,30.8,0.4,1.3,2.7,7.2,6.1,3.0,97.9,6.3,1.2
STREATHAM,53288,53229,21117,29088,0,0,3,3021,50205,29088,0,0,3,3024,2354,87,50454,0,0,39.6,54.6,0.0,0.0,0.0,5.7,39.6,54.6,0.0,0.0,0.0,5.7,4.4,0.2,94.7,0.0,0.0
STRETFORD AND URMSTON,47252,47143,16601,30000,5,62,50,425,46601,30000,5,67,117,542,1641,226,46824,848,0,35.1,63.5,0.0,0.1,0.1,0.9,35.1,63.5,0.0,0.1,0.2,1.1,3.5,0.5,99.1,1.8,0.0
STROUD,50200,50177,39623,4887,184,554,578,4351,44510,4887,184,738,1316,5667,2831,1572,47491,2951,402,78.9,9.7,0.4,1.1,1.2,8.7,78.9,9.7,0.4,1.5,2.6,11.3,5.6,3.1,94.6,5.9,0.8
SUFFOLK COASTAL,56633,56513,41385,10158,266,586,801,3317,51543,10158,266,852,1653,4970,3356,1945,55168,0,0,73.1,17.9,0.5,1.0,1.4,5.9,73.1,17.9,0.5,1.5,2.9,8.8,5.9,3.4,97.4,0.0,0.0
SUNDERLAND CENTRAL,51226,51152,25553,24439,27,24,196,913,49992,24439,27,51,247,1160,804,344,50145,0,0,49.9,47.7,0.1,0.0,0.4,1.8,49.9,47.7,0.1,0.1,0.5,2.3,1.6,0.7,97.9,0.0,0.0
SURREY HEATH,46902,46899,13753,32046,0,22,140,938,45799,32046,0,22,162,1100,2571,169,46693,0,0,29.3,68.3,0.0,0.0,0.3,2.0,29.3,68.3,0.0,0.0,0.3,2.3,5.5,0.4,99.6,0.0,0.0
SUTTON AND CHEAM,44558,44552,8100,35494,0,9,2,947,43594,35494,0,9,11,958,864,17,43676,0,0,18.2,79.7,0.0,0.0,0.0,2.1,18.2,79.7,0.0,0.0,0.0,2.2,1.9,0.0,98.0,0.0,0.0
SUTTON COLDFIELD,43416,43402,7941,34340,54,41,201,825,42281,34340,54,95,296,1121,8949,414,42318,0,0,18.3,79.1,0.1,0.1,0.5,1.9,18.3,79.1,0.1,0.2,0.7,2.6,20.6,1.0,97.5,0.0,0.0
SWANSEA EAST,40114,40076,16169,23285,1,5,45,571,39454,23285,1,6,51,622,6151,147,39656,14320,11530,40.3,58.0,0.0,0.0,0.1,1.4,40.3,58.0,0.0,0.0,0.1,1.6,15.3,0.4,98.9,35.7,28.7
SWANSEA WEST,40130,39961,5771,33974,0,1,43,172,39745,33974,0,1,44,216,5727,223,39850,3957,152,14.4,84.7,0.0,0.0,0.1,0.4,14.4,84.7,0.0,0.0,0.1,0.5,14.3,0.6,99.3,9.9,0.4
TAMWORTH,43844,43815,11301,31176,162,83,190,903,42477,31176,162,245,435,1338,1529,489,43659,0,0,25.8,71.1,0.4,0.2,0.4,2.1,25.8,71.1,0.4,0.6,1.0,3.1,3.5,1.1,99.6,0.0,0.0
TATTON,41925,41881,19323,19152,138,276,491,2501,38475,19152,138,414,905,3406,2598,1014,41227,2170,0,46.1,45.7,0.3,0.7,1.2,6.0,46.1,45.7,0.3,1.0,2.2,8.1,6.2,2.4,98.3,5.2,0.0
TAUNTON DEANE,57480,57440,43359,7905,329,884,1281,3682,51264,7905,329,1213,2494,6176,2385,2835,54859,3,0,75.4,13.8,0.6,1.5,2.2,6.4,75.4,13.8,0.6,2.1,4.3,10.7,4.1,4.9,95.4,0.0,0.0
TELFORD,45174,45148,11221,33177,0,2,72,676,44398,33177,0,2,74,750,1670,102,44708,9266,2073,24.8,73.4,0.0,0.0,0.2,1.5,24.8,73.4,0.0,0.0,0.2,1.7,3.7,0.2,99.0,20.5,4.6
TEWKESBURY,53642,53513,19518,28891,112,675,763,3554,48409,28891,112,787,1550,5104,8060,1946,49337,5917,0,36.4,53.9,0.2,1.3,1.4,6.6,36.4,53.9,0.2,1.5,2.9,9.5,15.0,3.6,92.0,11.0,0.0
THE COTSWOLDS,52842,52826,30480,15936,185,561,1343,4321,46416,15936,185,746,2089,6410,15885,2623,48670,48,48,57.7,30.2,0.4,1.1,2.5,8.2,57.7,30.2,0.4,1.4,4.0,12.1,30.1,5.0,92.1,0.1,0.1
THE WREKIN,43559,43524,10848,30735,97,196,352,1296,41583,30735,97,293,645,1941,682,695,43266,6987,1151,24.9,70.6,0.2,0.4,0.8,3.0,24.9,70.6,0.2,0.7,1.5,4.5,1.6,1.6,99.3,16.0,2.6
THIRSK AND MALTON,54353,54089,42632,3088,1277,1283,1580,4229,45720,3088,1277,2560,4140,8369,3086,4578,51704,14473,6299,78.4,5.7,2.3,2.4,2.9,7.8,78.4,5.7,2.3,4.7,7.6,15.4,5.7,8.4,95.1,26.6,11.6
THORNBURY AND YATE,39233,39222,15298,21940,127,204,307,1346,37238,21940,127,331,638,1984,3338,692,38736,0,0,39.0,55.9,0.3,0.5,0.8,3.4,39.0,55.9,0.3,0.8,1.6,5.1,8.5,1.8,98.7,0.0,0.0
THURROCK,53026,53019,9015,41824,8,135,852,1185,50839,41824,8,143,995,2180,3869,1020,51198,0,0,17.0,78.9,0.0,0.3,1.6,2.2,17.0,78.9,0.0,0.3,1.9,4.1,7.3,1.9,96.6,0.0,0.0
TIVERTON AND HONITON,50487,50411,39163,1331,596,1491,2169,5661,40494,1331,596,2087,4256,9917,1331,4557,46866,103,1,77.6,2.6,1.2,3.0,4.3,11.2,77.6,2.6,1.2,4.1,8.4,19.6,2.6,9.0,92.8,0.2,0.0
TONBRIDGE AND MALLING,46261,46239,20753,21732,191,216,460,2887,42485,21732,191,407,867,3754,3721,942,45510,0,0,44.9,47.0,0.4,0.5,1.0,6.2,44.9,47.0,0.4,0.9,1.9,8.1,8.0,2.0,98.4,0.0,0.0
TOOTING,47798,47767,15937,29831,0,0,111,1888,45768,29831,0,0,111,1999,985,226,45795,0,0,33.3,62.4,0.0,0.0,0.2,3.9,33.3,62.4,0.0,0.0,0.2,4.2,2.1,0.5,95.8,0.0,0.0
TORBAY,58875,58677,15030,40239,4,3,97,3304,55269,40239,4,7,104,3408,11470,377,56202,941,0,25.5,68.3,0.0,0.0,0.2,5.6,25.5,68.3,0.0,0.0,0.2,5.8,19.5,0.6,95.5,1.6,0.0
TORFAEN,40883,40854,24528,14360,35,99,298,1534,38888,14360,35,134,432,1966,1409,558,39710,22231,17991,60.0,35.1,0.1,0.2,0.7,3.8,60.0,35.1,0.1,0.3,1.1,4.8,3.4,1.4,97.1,54.4,44.0
TORRIDGE AND WEST DEVON,50248,50141,38934,1273,1081,2277,2334,4242,40207,1273,1081,3358,5692,9934,1273,5995,47004,16188,8298,77.5,2.5,2.2,4.5,4.6,8.4,77.5,2.5,2.2,6.7,11.3,19.8,2.5,11.9,93.5,32.2,16.5
TOTNES,50176,50048,39086,3366,321,835,1540,4900,42452,3366,321,1156,2696,7596,525,2927,47754,3973,1211,77.9,6.7,0.6,1.7,3.1,9.8,77.9,6.7,0.6,2.3,5.4,15.1,1.0,5.8,95.2,7.9,2.4
TOTTENHAM,53410,53393,6290,46471,0,75,116,441,52761,46471,0,75,191,632,1584,282,52771,0,0,11.8,87.0,0.0,0.1,0.2,0.8,11.8,87.0,0.0,0.1,0.4,1.2,3.0,0.5,98.8,0.0,0.0
TRURO AND FALMOUTH,50196,50071,25955,19379,113,319,600,3705,45334,19379,113,432,1032,4737,19266,1327,48164,0,0,51.7,38.6,0.2,0.6,1.2,7.4,51.7,38.6,0.2,0.9,2.1,9.4,38.4,2.6,96.0,0.0,0.0
TUNBRIDGE WELLS,47832,47811,20377,23786,41,349,666,2592,44163,23786,41,390,1056,3648,3485,1127,47010,0,0,42.6,49.7,0.1,0.7,1.4,5.4,42.6,49.7,0.1,0.8,2.2,7.6,7.3,2.4,98.3,0.0,0.0
TWICKENHAM,52179,52114,9036,42358,1,2,122,595,51394,42358,1,3,125,720,10422,252,51466,0,0,17.3,81.2,0.0,0.0,0.2,1.1,17.3,81.2,0.0,0.0,0.2,1.4,20.0,0.5,98.6,0.0,0.0
TYNEMOUTH,48511,48395,8069,39644,24,107,98,453,47713,39644,24,131,229,682,415,352,48009,0,0,16.6,81.7,0.0,0.2,0.2,0.9,16.6,81.7,0.0,0.3,0.5,1.4,0.9,0.7,99.0,0.0,0.0
UPPER BANN,52717,52482,23143,26532,218,201,292,2096,49675,26532,218,419,711,2807,26708,955,52343,0,0,43.9,50.3,0.4,0.4,0.6,4.0,43.9,50.3,0.4,0.8,1.3,5.3,50.7,1.8,99.3,0.0,0.0
UXBRIDGE AND SOUTH RUISLIP,45181,44802,6546,35956,17,158,209,1916,42502,35956,17,175,384,2300,1801,1008,42761,0,0,14.5,79.6,0.0,0.3,0.5,4.2,14.5,79.6,0.0,0.4,0.8,5.1,4.0,2.2,94.6,0.0,0.0
VALE OF CLWYD,37561,37516,34266,1478,35,82,304,1351,35744,1478,35,117,421,1772,1478,518,36739,21699,1303,91.2,3.9,0.1,0.2,0.8,3.6,91.2,3.9,0.1,0.3,1.1,4.7,3.9,1.4,97.8,57.8,3.5
VALE OF GLAMORGAN,47518,47486,21771,23529,189,285,309,1403,45300,23529,189,474,783,2186,3141,856,46658,2089,485,45.8,49.5,0.4,0.6,0.7,3.0,45.8,49.5,0.4,1.0,1.6,4.6,6.6,1.8,98.2,4.4,1.0
VAUXHALL,66313,66179,13280,49310,0,0,0,3589,62590,49310,0,0,0,3589,9907,134,62610,0,0,20.0,74.4,0.0,0.0,0.0,5.4,20.0,74.4,0.0,0.0,0.0,5.4,14.9,0.2,94.4,0.0,0.0
WAKEFIELD,45083,45033,14190,29168,1,11,159,1504,43358,29168,1,12,171,1675,7403,354,43927,0,0,31.5,64.7,0.0,0.0,0.4,3.3,31.5,64.7,0.0,0.0,0.4,3.7,16.4,0.8,97.4,0.0,0.0
WALLASEY,43761,43748,11152,32077,6,3,10,500,43229,32077,6,9,19,519,24605,41,43623,0,0,25.5,73.3,0.0,0.0,0.0,1.1,25.5,73.3,0.0,0.0,0.0,1.2,56.2,0.1,99.7,0.0,0.0
WALSALL NORTH,42579,42575,15796,26130,0,0,419,230,41926,26130,0,0,419,649,3007,423,42042,0,0,37.1,61.4,0.0,0.0,1.0,0.5,37.1,61.4,0.0,0.0,1.0,1.5,7.1,1.0,98.7,0.0,0.0
WALSALL SOUTH,42201,42176,17957,23541,0,16,56,606,41498,23541,0,16,72,678,3568,103,41938,0,0,42.6,55.8,0.0,0.0,0.1,1.4,42.6,55.8,0.0,0.0,0.2,1.6,8.5,0.2,99.4,0.0,0.0
WALTHAMSTOW,48916,48432,4368,42423,0,0,237,1404,46791,42423,0,0,237,1641,12960,908,46845,0,0,8.9,86.7,0.0,0.0,0.5,2.9,8.9,86.7,0.0,0.0,0.5,3.4,26.5,1.9,95.8,0.0,0.0
WANSBECK,40337,40329,37146,1773,22,35,40,1313,38919,1773,22,57,97,1410,573,105,40255,0,0,92.1,4.4,0.1,0.1,0.1,3.3,92.1,4.4,0.1,0.1,0.2,3.5,1.4,0.3,99.8,0.0,0.0
WANTAGE,56810,56781,23090,31061,96,221,430,1883,54151,31061,96,317,747,2630,11289,785,56432,0,0,40.6,54.7,0.2,0.4,0.8,3.3,40.6,54.7,0.2,0.6,1.3,4.6,19.9,1.4,99.3,0.0,0.0
WARLEY,41226,41213,14221,26738,3,4,49,198,40959,26738,3,7,56,254,2765,71,41052,0,0,34.5,64.9,0.0,0.0,0.1,0.5,34.5,64.9,0.0,0.0,0.1,0.6,6.7,0.2,99.6,0.0,0.0
WARRINGTON NORTH,45640,45614,18527,25970,36,14,53,1014,44497,25970,36,50,103,1117,557,162,45480,570,34,40.6,56.9,0.1,0.0,0.1,2.2,40.6,56.9,0.1,0.1,0.2,2.4,1.2,0.4,99.6,1.2,0.1
WARRINGTON SOUTH,52782,52716,20227,30691,5,59,53,1681,50918,30691,5,64,117,1798,484,185,52299,1,0,38.3,58.1,0.0,0.1,0.1,3.2,38.3,58.1,0.0,0.1,0.2,3.4,0.9,0.4,99.1,0.0,0.0
WARWICK AND LEAMINGTON,49689,49654,11787,36827,7,388,168,477,48614,36827,7,395,563,1040,4323,598,49095,1261,413,23.7,74.1,0.0,0.8,0.3,1.0,23.7,74.1,0.0,0.8,1.1,2.1,8.7,1.2,98.8,2.5,0.8
WASHINGTON AND SUNDERLAND WEST,41825,41778,10235,30110,51,139,516,727,40345,30110,51,190,706,1433,42,807,40819,0,0,24.5,72.0,0.1,0.3,1.2,1.7,24.5,72.0,0.1,0.5,1.7,3.4,0.1,1.9,97.6,0.0,0.0
WATFORD,52834,52807,8456,43903,2,38,94,314,52359,43903,2,40,134,448,625,177,52533,0,0,16.0,83.1,0.0,0.1,0.2,0.6,16.0,83.1,0.0,0.1,0.3,0.8,1.2,0.3,99.4,0.0,0.0
WAVENEY,51810,51774,47590,1586,71,143,130,2254,49176,1586,71,214,344,2598,1586,476,51131,0,0,91.9,3.1,0.1,0.3,0.3,4.4,91.9,3.1,0.1,0.4,0.7,5.0,3.1,0.9,98.7,0.0,0.0
WEALDEN,48592,48573,41659,3179,134,314,357,2930,44838,3179,134,448,805,3735,3178,838,48362,0,0,85.7,6.5,0.3,0.6,0.7,6.0,85.7,6.5,0.3,0.9,1.7,7.7,6.5,1.7,99.5,0.0,0.0
WEAVER VALE,44079,44060,31198,10938,79,70,168,1607,42136,10938,79,149,317,1924,1489,349,43894,0,0,70.8,24.8,0.2,0.2,0.4,3.6,70.8,24.8,0.2,0.3,0.7,4.4,3.4,0.8,99.6,0.0,0.0
WELLINGBOROUGH,52573,52547,26443,24980,12,155,166,791,51423,24980,12,167,333,1124,1638,382,52066,5029,4953,50.3,47.5,0.0,0.3,0.3,1.5,50.3,47.5,0.0,0.3,0.6,2.1,3.1,0.7,99.0,9.6,9.4
WELLS,52687,52622,40936,5364,427,652,844,4399,46300,5364,427,1079,1923,6322,1697,2106,50515,0,0,77.7,10.2,0.8,1.2,1.6,8.3,77.7,10.2,0.8,2.0,3.6,12.0,3.2,4.0,95.9,0.0,0.0
WELWYN HATFIELD,47312,47306,12991,32881,8,37,222,1167,45872,32881,8,45,267,1434,1618,275,46941,0,0,27.5,69.5,0.0,0.1,0.5,2.5,27.5,69.5,0.0,0.1,0.6,3.0,3.4,0.6,99.2,0.0,0.0
WENTWORTH AND DEARNE,47589,47583,24526,21889,13,136,171,848,46415,21889,13,149,320,1168,5102,356,47253,0,0,51.5,46.0,0.0,0.3,0.4,1.8,51.5,46.0,0.0,0.3,0.7,2.5,10.7,0.7,99.3,0.0,0.0
WEST ABERDEENSHIRE AND KINCARDINE,44762,44310,34456,1456,1210,1513,1828,3847,35912,1456,1210,2723,4551,8398,1316,5213,41545,0,0,77.0,3.3,2.7,3.4,4.1,8.6,77.0,3.3,2.7,6.1,10.2,18.8,2.9,11.6,92.8,0.0,0.0
WEST BROMWICH EAST,39804,39798,9915,29468,1,3,204,207,39383,29468,1,4,208,415,286,259,39473,0,0,24.9,74.0,0.0,0.0,0.5,0.5,24.9,74.0,0.0,0.0,0.5,1.0,0.7,0.7,99.2,0.0,0.0
WEST BROMWICH WEST,42245,42224,13129,28869,0,10,55,161,41998,28869,0,10,65,226,337,95,42028,0,0,31.1,68.3,0.0,0.0,0.1,0.4,31.1,68.3,0.0,0.0,0.2,0.5,0.8,0.2,99.5,0.0,0.0
WEST DORSET,52666,52654,44576,3161,165,596,747,3409,47737,3161,165,761,1508,4917,2577,1570,51432,1502,1502,84.6,6.0,0.3,1.1,1.4,6.5,84.6,6.0,0.3,1.4,2.9,9.3,4.9,3.0,97.7,2.9,2.9
WEST DUNBARTONSHIRE,46981,46973,4755,41459,19,78,129,533,46214,41459,19,97,226,759,199,276,46531,0,0,10.1,88.2,0.0,0.2,0.3,1.1,10.1,88.2,0.0,0.2,0.5,1.6,0.4,0.6,99.0,0.0,0.0
WEST HAM,72163,72154,9207,61340,1,8,222,1376,70547,61340,1,9,231,1607,11542,295,70552,0,0,12.8,85.0,0.0,0.0,0.3,1.9,12.8,85.0,0.0,0.0,0.3,2.2,16.0,0.4,97.8,0.0,0.0
WEST LANCASHIRE,43891,43876,31944,9452,115,298,347,1720,41396,9452,115,413,760,2480,6467,810,43383,6575,1369,72.8,21.5,0.3,0.7,0.8,3.9,72.8,21.5,0.3,0.9,1.7,5.7,14.7,1.8,98.8,15.0,3.1
WESTMINSTER NORTH,62440,62368,44369,15125,0,0,2,2872,59494,15125,0,0,2,2874,10356,80,59507,0,0,71.1,24.2,0.0,0.0,0.0,4.6,71.1,24.2,0.0,0.0,0.0,4.6,16.6,0.1,95.3,0.0,0.0
WESTMORLAND AND LONSDALE,49503,49399,40729,4902,253,351,606,2558,45631,4902,253,604,1210,3768,4852,1393,48646,22168,18701,82.3,9.9,0.5,0.7,1.2,5.2,82.3,9.9,0.5,1.2,2.4,7.6,9.8,2.8,98.3,44.8,37.8
WESTON-SUPER-MARE,54718,54503,39756,9419,57,211,803,4257,49175,9419,57,268,1071,5328,4471,1370,52615,0,0,72.7,17.2,0.1,0.4,1.5,7.8,72.7,17.2,0.1,0.5,2.0,9.7,8.2,2.5,96.2,0.0,0.0
WEST SUFFOLK,55337,55308,41240,10624,142,284,280,2738,51864,10624,142,426,706,3444,1491,760,54752,119,0,74.5,19.2,0.3,0.5,0.5,4.9,74.5,19.2,0.3,0.8,1.3,6.2,2.7,1.4,98.9,0.2,0.0
WEST TYRONE,38593,37890,20337,8332,2606,1863,1294,3458,28669,8332,2606,4469,5763,9221,8331,6478,37490,2154,456,52.7,21.6,6.8,4.8,3.4,9.0,52.7,21.6,6.8,11.6,14.9,23.9,21.6,16.8,97.1,5.6,1.2
WEST WORCESTERSHIRE,47425,47307,37186,3806,309,881,1245,3880,40992,3806,309,1190,2435,6315,2349,2677,45669,13104,5780,78.4,8.0,0.7,1.9,2.6,8.2,78.4,8.0,0.7,2.5,5.1,13.3,5.0,5.6,96.3,27.6,12.2
WIGAN,50122,50121,13583,35576,10,60,136,756,49159,35576,10,70,206,962,404,231,49766,16485,270,27.1,71.0,0.0,0.1,0.3,1.5,27.1,71.0,0.0,0.1,0.4,1.9,0.8,0.5,99.3,32.9,0.5
WIMBLEDON,45270,45267,8325,36175,1,10,133,623,44500,36175,1,11,144,767,6281,285,44529,0,0,18.4,79.9,0.0,0.0,0.3,1.4,18.4,79.9,0.0,0.0,0.3,1.7,13.9,0.6,98.4,0.0,0.0
WINCHESTER,45022,45006,18542,23942,73,212,276,1961,42484,23942,73,285,561,2522,1002,617,44343,0,0,41.2,53.2,0.2,0.5,0.6,4.4,41.2,53.2,0.2,0.6,1.2,5.6,2.2,1.4,98.5,0.0,0.0
WINDSOR,47774,47737,21470,22568,82,103,277,3237,44038,22568,82,185,462,3699,1636,622,46270,0,0,44.9,47.2,0.2,0.2,0.6,6.8,44.9,47.2,0.2,0.4,1.0,7.7,3.4,1.3,96.9,0.0,0.0
WIRRAL SOUTH,34435,34427,14479,18572,25,33,37,1281,33051,18572,25,58,95,1376,413,103,34398,1827,0,42.0,53.9,0.1,0.1,0.1,3.7,42.0,53.9,0.1,0.2,0.3,4.0,1.2,0.3,99.9,5.3,0.0
WIRRAL WEST,32935,32930,26992,3578,6,47,99,2208,30570,3578,6,53,152,2360,497,183,32572,309,0,82.0,10.9,0.0,0.1,0.3,6.7,82.0,10.9,0.0,0.2,0.5,7.2,1.5,0.6,98.9,0.9,0.0
WITHAM,42578,42556,33602,4394,267,496,469,3328,37996,4394,267,763,1232,4560,1643,1317,40481,0,0,78.9,10.3,0.6,1.2,1.1,7.8,78.9,10.3,0.6,1.8,2.9,10.7,3.9,3.1,95.1,0.0,0.0
WITNEY,51010,50989,23805,24813,67,263,590,1451,48618,24813,67,330,920,2371,8526,1060,49940,0,0,46.7,48.6,0.1,0.5,1.2,2.8,46.7,48.6,0.1,0.6,1.8,4.6,16.7,2.1,97.9,0.0,0.0
WOKING,47414,47401,8925,37283,0,149,31,1013,46208,37283,0,149,180,1193,1623,193,47078,0,0,18.8,78.6,0.0,0.3,0.1,2.1,18.8,78.6,0.0,0.3,0.4,2.5,3.4,0.4,99.3,0.0,0.0
WOKINGHAM,51175,50562,20989,26050,18,108,519,2878,47039,26050,18,126,645,3523,5697,1587,48557,0,0,41.0,50.9,0.0,0.2,1.0,5.6,41.0,50.9,0.0,0.2,1.3,6.9,11.1,3.1,94.9,0.0,0.0
WOLVERHAMPTON NORTH EAST,41179,41125,7622,32690,0,1,260,552,40312,32690,0,1,261,813,359,315,40353,0,0,18.5,79.4,0.0,0.0,0.6,1.3,18.5,79.4,0.0,0.0,0.6,2.0,0.9,0.8,98.0,0.0,0.0
WOLVERHAMPTON SOUTH EAST,41667,41616,4607,36634,0,3,18,354,41241,36634,0,3,21,375,220,74,41537,0,0,11.1,87.9,0.0,0.0,0.0,0.8,11.1,87.9,0.0,0.0,0.1,0.9,0.5,0.2,99.7,0.0,0.0
WOLVERHAMPTON SOUTH WEST,40834,40819,5775,34040,0,0,15,989,39815,34040,0,0,15,1004,549,71,39883,0,0,14.1,83.4,0.0,0.0,0.0,2.4,14.1,83.4,0.0,0.0,0.0,2.5,1.3,0.2,97.7,0.0,0.0
WORCESTER,48646,48607,44546,3191,0,1,10,859,47737,3191,0,1,11,870,599,51,48436,20925,2229,91.6,6.6,0.0,0.0,0.0,1.8,91.6,6.6,0.0,0.0,0.0,1.8,1.2,0.1,99.6,43.0,4.6
WORKINGTON,40898,40843,37396,617,332,402,311,1785,38013,617,332,734,1045,2830,617,1142,40334,38,38,91.4,1.5,0.8,1.0,0.8,4.4,91.4,1.5,0.8,1.8,2.6,6.9,1.5,2.8,98.6,0.1,0.1
WORSLEY AND ECCLES SOUTH,49457,49451,5149,43402,12,106,188,594,48551,43402,12,118,306,900,25119,491,48756,735,0,10.4,87.8,0.0,0.2,0.4,1.2,10.4,87.8,0.0,0.2,0.6,1.8,50.8,1.0,98.6,1.5,0.0
WORTHING WEST,49593,49586,20004,29088,0,1,8,485,49092,29088,0,1,9,494,932,16,49523,0,0,40.3,58.7,0.0,0.0,0.0,1.0,40.3,58.7,0.0,0.0,0.0,1.0,1.9,0.0,99.9,0.0,0.0
WREXHAM,35137,34641,18909,14464,20,98,97,1053,33373,14464,20,118,215,1268,14479,787,34079,13776,469,53.8,41.2,0.1,0.3,0.3,3.0,53.8,41.2,0.1,0.3,0.6,3.6,41.2,2.2,97.0,39.2,1.3
WYCOMBE,47139,47058,29453,15747,50,285,139,1384,45200,15747,50,335,474,1858,844,555,46688,0,0,62.5,33.4,0.1,0.6,0.3,2.9,62.5,33.4,0.1,0.7,1.0,3.9,1.8,1.2,99.0,0.0,0.0
WYRE AND PRESTON NORTH,44343,44280,27985,13651,77,98,337,2132,41636,13651,77,175,512,2644,3913,613,43606,13351,7272,63.1,30.8,0.2,0.2,0.8,4.8,63.1,30.8,0.2,0.4,1.2,6.0,8.8,1.4,98.3,30.1,16.4
WYRE FOREST,48100,48061,23724,22479,140,151,371,1196,46203,22479,140,291,662,1858,420,723,47829,1412,172,49.3,46.7,0.3,0.3,0.8,2.5,49.3,46.7,0.3,0.6,1.4,3.9,0.9,1.5,99.4,2.9,0.4
WYTHENSHAWE AND SALE EAST,50461,50409,6583,42414,12,185,493,722,48997,42414,12,197,690,1412,8461,960,49304,1958,1460,13.0,84.1,0.0,0.4,1.0,1.4,13.0,84.1,0.0,0.4,1.4,2.8,16.8,1.9,97.7,3.9,2.9
YEOVIL,55109,55003,49294,508,223,878,615,3485,49802,508,223,1101,1716,5201,508,1894,53976,74,74,89.4,0.9,0.4,1.6,1.1,6.3,89.4,0.9,0.4,2.0,3.1,9.4,0.9,3.4,97.9,0.1,0.1
YNYS MÔN,36935,36825,27003,5813,260,494,543,2712,32816,5813,260,754,1297,4009,5813,1462,35578,8311,2569,73.1,15.7,0.7,1.3,1.5,7.3,73.1,15.7,0.7,2.0,3.5,10.9,15.7,4.0,96.3,22.5,7.0
YORK CENTRAL,53892,53727,8004,42226,0,22,158,3317,50230,42226,0,22,180,3497,21245,376,50311,2294,778,14.9,78.4,0.0,0.0,0.3,6.2,14.9,78.4,0.0,0.0,0.3,6.5,39.4,0.7,93.4,4.3,1.4
YORK OUTER,44843,44821,14751,27645,36,203,210,1976,42396,27645,36,239,449,2425,21832,636,44108,4662,3033,32.9,61.6,0.1,0.5,0.5,4.4,32.9,61.6,0.1,0.5,1.0,5.4,48.7,1.4,98.4,10.4,6.8
