parl_const,parliamentary_constituency_name,All Premises,All Matched Premises,SFBB availability (% premises),UFBB (100Mbit/s) availability (% premises),UFBB availability (% premises),Full Fibre availability (% premises),Gigabit availability (% premises),% of premises unable to receive 2Mbit/s,% of premises unable to receive 5Mbit/s,% of premises unable to receive 10Mbit/s,% of premises unable to receive 30Mbit/s,% of premises below the USO,% of premises with NGA,Number of premises with SFBB availability,Number of premises with UFBB (100Mbit/s) availability,Number of premises with UFBB availability,Number of premises unable to receive 2Mbit/s,Number of premises unable to receive 5Mbit/s,Number of premises unable to receive 10Mbit/s,Number of premises unable to receive 30Mbit/s,Number of premises with Full Fibre availability,Number of premises with Gigabit availability,Number of premises below the USO,Number of premises with NGA,Number of premises able to receive decent broadband from FWA,% of premises with 30<300Mbit/s download speed,% of premises with >=300Mbit/s download speed,% of premises able to receive decent broadband from FWA,% of premises with 0<2Mbit/s download speed,% of premises with 2<5Mbit/s download speed,% of premises with 5<10Mbit/s download speed,% of premises with 10<30Mbit/s download speed,Number of premises with 30<300Mbit/s download speed,Number of premises with >=300Mbit/s download speed,Number of premises with 0<2Mbit/s download speed,Number of premises with 2<5Mbit/s download speed,Number of premises with 5<10Mbit/s download speed,Number of premises with 10<30Mbit/s download speed
E14000530,ALDERSHOT,47471,47432,97.4,81.5,81.3,4.2,4.2,0.1,0.8,1.4,2.5,0.2,97.7,46244,38697,38583,50,392,647,1188,2004,2004,74,46359,0,16.1,81.3,0.0,0.1,0.7,0.5,1.1,7661,38583,50,342,255,541
E14000531,ALDRIDGE-BROWNHILLS,34609,34603,99.1,84.4,80.4,17.7,78.5,0.0,0.0,0.1,0.9,0.0,99.8,34295,29196,27814,2,4,28,308,6120,27160,6,34541,0,18.7,80.4,0.0,0.0,0.0,0.1,0.8,6481,27814,2,2,24,280
E14000532,ALTRINCHAM AND SALE WEST,45006,44890,96.7,70.5,62.1,1.9,55.4,0.1,0.4,0.5,3.1,0.3,98.8,43511,31724,27965,46,186,242,1379,874,24951,129,44484,0,34.5,62.1,0.0,0.1,0.3,0.1,2.5,15546,27965,46,140,56,1137
E14000533,AMBER VALLEY,43916,43818,95.1,27.4,26.9,26.8,26.8,0.1,0.3,0.7,4.7,0.3,99.1,41746,12017,11792,23,120,299,2072,11751,11751,140,43525,0,68.2,26.9,0.0,0.1,0.2,0.4,4.0,29954,11792,23,97,179,1773
E14000534,ARUNDEL AND SOUTH DOWNS,49115,48710,90.0,8.5,7.4,6.6,6.6,0.4,1.2,2.5,9.2,1.7,98.0,44206,4195,3615,215,609,1229,4504,3223,3223,838,48153,0,82.6,7.4,0.0,0.4,0.8,1.3,6.7,40591,3615,215,394,620,3275
E14000535,ASHFIELD,49822,49722,98.1,87.6,87.4,3.8,3.8,0.0,0.4,0.5,1.7,0.3,98.9,48873,43630,43535,9,201,247,849,1913,1913,172,49285,0,10.7,87.4,0.0,0.0,0.4,0.1,1.2,5338,43535,9,192,46,602
E14000536,ASHFORD,55964,55822,91.0,50.5,47.3,7.8,7.8,0.3,1.6,3.2,8.8,0.9,98.6,50913,28255,26467,184,894,1770,4909,4348,4348,508,55175,0,43.7,47.3,0.0,0.3,1.3,1.6,5.6,24446,26467,184,710,876,3139
E14000537,ASHTON-UNDER-LYNE,47898,47766,98.7,81.2,80.4,38.7,38.9,0.0,0.0,0.1,1.0,0.3,99.3,47277,38884,38492,1,9,45,489,18531,18640,131,47558,0,18.3,80.4,0.0,0.0,0.0,0.1,0.9,8785,38492,1,8,36,444
E14000538,AYLESBURY,53666,53542,96.8,68.5,63.4,9.3,9.3,0.0,0.3,0.6,3.0,0.3,98.9,51929,36752,34016,14,165,308,1613,4997,4997,180,53066,0,33.4,63.4,0.0,0.0,0.3,0.3,2.4,17913,34016,14,151,143,1305
E14000539,BANBURY,59654,59528,96.1,41.0,30.8,9.7,9.7,0.3,0.4,1.0,3.7,0.3,98.5,57332,24455,18372,150,249,615,2196,5796,5796,206,58779,0,65.3,30.8,0.0,0.3,0.2,0.6,2.7,38960,18372,150,99,366,1581
E14000540,BARKING,53392,53378,98.8,86.7,86.5,49.1,49.1,0.0,0.2,0.3,1.1,0.0,98.8,52766,46299,46163,2,82,139,612,26202,26202,23,52773,0,12.4,86.5,0.0,0.0,0.1,0.1,0.9,6603,46163,2,80,57,473
E14000541,BARNSLEY CENTRAL,44981,44783,98.6,86.4,85.2,14.8,14.8,0.0,0.1,0.2,1.0,0.4,99.0,44353,38876,38303,0,41,81,430,6663,6665,198,44550,0,13.5,85.2,0.0,0.0,0.1,0.1,0.8,6050,38303,0,41,40,349
E14000542,BARNSLEY EAST,44396,44355,98.5,80.8,75.8,40.7,40.7,0.0,0.1,0.2,1.4,0.1,99.3,43739,35887,33664,15,41,78,616,18089,18089,42,44106,0,22.7,75.8,0.0,0.0,0.1,0.1,1.2,10075,33664,15,26,37,538
E14000543,BARROW AND FURNESS,46139,46070,96.9,1.1,1.1,1.1,1.1,0.2,0.5,0.8,2.9,0.5,99.7,44722,525,525,102,229,375,1348,525,525,221,45985,1168,95.8,1.1,2.5,0.2,0.3,0.3,2.1,44197,525,102,127,146,973
E14000544,BASILDON AND BILLERICAY,43552,43482,97.3,67.7,66.9,20.9,20.9,0.0,0.2,0.4,2.5,0.2,99.4,42393,29499,29147,9,95,192,1089,9110,9110,72,43288,0,30.4,66.9,0.0,0.0,0.2,0.2,2.1,13246,29147,9,86,97,897
E14000545,BASINGSTOKE,52691,52676,99.0,67.4,67.0,17.9,67.2,0.0,0.2,0.4,1.0,0.1,99.6,52157,35509,35304,0,85,193,519,9439,35400,73,52468,0,32.0,67.0,0.0,0.0,0.2,0.2,0.6,16853,35304,0,85,108,326
E14000546,BASSETLAW,52128,51934,96.0,35.0,28.0,6.1,6.1,0.4,0.7,1.0,3.6,0.5,99.2,50032,18267,14585,197,345,533,1902,3169,3169,277,51685,3734,68.0,28.0,7.2,0.4,0.3,0.4,2.6,35447,14585,197,148,188,1369
E14000547,BATH,45472,45430,95.6,69.4,60.4,24.7,24.7,0.0,0.0,0.2,4.3,0.1,96.8,43491,31576,27485,0,10,73,1939,11220,11220,46,44038,0,35.2,60.4,0.0,0.0,0.0,0.1,4.1,16006,27485,0,10,63,1866
E14000548,BATLEY AND SPEN,49671,49622,97.1,67.0,66.5,24.0,25.2,0.0,0.1,0.1,2.8,0.1,99.2,48219,33295,33040,3,27,57,1403,11936,12498,51,49286,0,30.6,66.5,0.0,0.0,0.0,0.1,2.7,15179,33040,3,24,30,1346
E14000549,BATTERSEA,61799,61475,97.4,93.2,89.1,36.8,36.8,0.0,0.0,0.0,2.1,0.5,97.4,60204,57625,55034,0,0,17,1271,22731,22731,326,60206,0,8.4,89.1,0.0,0.0,0.0,0.0,2.0,5170,55034,0,0,17,1254
E14000550,BEACONSFIELD,46816,46762,92.7,38.8,33.5,11.1,14.0,0.0,0.3,1.3,7.1,0.3,98.1,43421,18145,15677,11,145,600,3341,5174,6553,131,45915,0,59.3,33.5,0.0,0.0,0.3,1.0,5.9,27744,15677,11,134,455,2741
E14000551,BECKENHAM,40798,40790,99.2,87.8,87.2,1.2,1.2,0.0,0.0,0.1,0.8,0.0,99.5,40468,35822,35586,2,4,28,322,478,478,8,40604,0,12.0,87.2,0.0,0.0,0.0,0.1,0.7,4882,35586,2,2,24,294
E14000552,BEDFORD,50071,50047,98.7,92.0,89.7,7.1,7.1,0.0,0.1,0.3,1.2,0.0,98.9,49443,46049,44897,9,75,128,604,3554,3554,25,49542,0,9.1,89.7,0.0,0.0,0.1,0.1,1.0,4546,44897,9,66,53,476
E14000553,BERMONDSEY AND OLD SOUTHWARK,76523,76287,90.1,72.0,70.5,56.0,56.0,0.0,0.0,0.4,9.6,0.3,90.2,68948,55060,53976,0,8,283,7339,42889,42889,236,68988,0,19.6,70.5,0.0,0.0,0.0,0.4,9.2,14972,53976,0,8,275,7056
E14000554,BERWICK-UPON-TWEED,38973,38871,89.2,8.4,8.4,8.4,8.4,1.3,2.9,4.5,10.5,1.7,96.8,34772,3265,3263,505,1124,1747,4099,3262,3262,671,37727,5351,80.8,8.4,13.7,1.3,1.6,1.6,6.0,31509,3263,505,619,623,2352
E14000555,BETHNAL GREEN AND BOW,65847,65644,90.4,65.3,59.7,26.7,26.7,0.0,0.0,0.4,9.3,0.3,90.5,59550,43004,39294,1,1,264,6094,17574,17574,201,59585,0,30.8,59.7,0.0,0.0,0.0,0.4,8.9,20256,39294,1,0,263,5830
E14000556,BEVERLEY AND HOLDERNESS,48782,48417,95.8,55.3,55.3,55.3,55.3,0.4,0.9,1.4,3.4,0.3,97.9,46742,26972,26972,192,436,702,1675,26972,26972,132,47759,14089,40.5,55.3,28.9,0.4,0.5,0.5,2.0,19770,26972,192,244,266,973
E14000557,BEXHILL AND BATTLE,52423,52228,93.5,7.1,7.1,7.1,7.1,0.1,0.4,1.3,6.1,0.6,99.2,49004,3728,3728,49,210,699,3224,3728,3728,338,52011,0,86.4,7.1,0.0,0.1,0.3,0.9,4.8,45276,3728,49,161,489,2525
E14000558,BEXLEYHEATH AND CRAYFORD,39008,38964,97.9,89.4,89.2,32.9,32.9,0.0,0.0,0.4,2.0,0.1,98.1,38199,34864,34813,0,1,147,765,12819,12819,42,38264,0,8.7,89.2,0.0,0.0,0.0,0.4,1.6,3386,34813,0,1,146,618
E14000559,BIRKENHEAD,46802,46764,99.4,86.9,86.4,45.2,45.2,0.0,0.0,0.0,0.6,0.1,99.8,46501,40670,40442,0,1,9,263,21176,21176,38,46698,0,12.9,86.4,0.0,0.0,0.0,0.0,0.5,6059,40442,0,1,8,254
E14000560,"BIRMINGHAM, EDGBASTON",45649,45625,94.4,86.3,85.7,15.9,85.8,0.0,0.3,2.0,5.5,0.1,94.5,43102,39400,39139,17,155,896,2523,7247,39161,24,43151,0,8.7,85.7,0.0,0.0,0.3,1.6,3.6,3963,39139,17,138,741,1627
E14000561,"BIRMINGHAM, ERDINGTON",45529,45510,96.1,91.2,89.0,14.6,87.2,0.0,0.2,2.1,3.9,0.0,96.1,43749,41531,40527,1,81,950,1761,6633,39697,19,43753,0,7.1,89.0,0.0,0.0,0.2,1.9,1.8,3222,40527,1,80,869,811
E14000562,"BIRMINGHAM, HALL GREEN",43538,43501,97.8,92.1,91.6,30.6,91.1,0.0,0.0,0.1,2.1,0.1,97.9,42593,40113,39864,0,8,49,908,13342,39683,33,42620,0,6.3,91.6,0.0,0.0,0.0,0.1,2.0,2729,39864,0,8,41,859
E14000563,"BIRMINGHAM, HODGE HILL",42528,42504,99.5,97.3,96.8,20.4,96.3,0.0,0.1,0.3,0.4,0.1,99.5,42317,41376,41172,0,50,144,187,8693,40955,24,42323,0,2.7,96.8,0.0,0.0,0.1,0.2,0.1,1145,41172,0,50,94,43
E14000564,"BIRMINGHAM, LADYWOOD",70842,70390,86.3,76.6,74.3,34.6,71.7,0.0,0.0,0.4,13.1,0.6,86.3,61138,54279,52655,0,19,301,9252,24507,50811,438,61139,0,12.0,74.3,0.0,0.0,0.0,0.4,12.6,8483,52655,0,19,282,8951
E14000565,"BIRMINGHAM, NORTHFIELD",47784,47768,97.3,92.4,92.2,14.1,92.2,0.0,0.0,1.3,2.7,0.0,97.4,46489,44150,44043,0,23,613,1279,6743,44043,16,46553,0,5.1,92.2,0.0,0.0,0.0,1.2,1.4,2446,44043,0,23,590,666
E14000566,"BIRMINGHAM, PERRY BARR",43236,43133,97.6,96.1,95.3,46.9,94.4,0.0,0.1,0.2,2.2,0.2,97.6,42189,41567,41190,0,55,108,944,20276,40831,102,42197,0,2.3,95.3,0.0,0.0,0.1,0.1,1.9,999,41190,0,55,53,836
E14000567,"BIRMINGHAM, SELLY OAK",45714,45271,96.6,93.1,92.5,40.6,93.1,0.0,0.0,0.4,2.5,1.0,96.7,44145,42552,42295,0,12,179,1126,18551,42548,443,44193,0,4.0,92.5,0.0,0.0,0.0,0.4,2.1,1850,42295,0,12,167,947
E14000568,"BIRMINGHAM, YARDLEY",45991,45964,98.8,97.5,97.1,77.5,96.8,0.0,0.0,0.6,1.1,0.0,98.8,45460,44832,44647,6,22,286,504,35640,44535,20,45462,0,1.8,97.1,0.0,0.0,0.0,0.6,0.5,813,44647,6,16,264,218
E14000569,BISHOP AUCKLAND,46778,46630,91.0,29.3,29.3,29.3,29.3,1.0,2.2,3.7,8.7,1.3,97.6,42560,13719,13709,474,1042,1742,4070,13718,13718,592,45671,631,61.7,29.3,1.3,1.0,1.2,1.5,5.0,28851,13709,474,568,700,2328
E14000570,BLACKBURN,47475,47351,98.4,72.8,72.6,5.8,5.8,0.0,0.1,0.2,1.4,0.3,98.9,46707,34584,34465,2,59,96,644,2759,2772,128,46948,7008,25.8,72.6,14.8,0.0,0.1,0.1,1.2,12242,34465,2,57,37,548
E14000571,BLACKLEY AND BROUGHTON,53623,53574,95.1,61.2,56.5,9.4,53.1,0.3,0.4,1.9,4.8,0.1,96.0,50995,32821,30316,144,201,1002,2579,5055,28470,48,51465,0,38.6,56.5,0.0,0.3,0.1,1.5,2.9,20679,30316,144,57,801,1577
E14000572,BLACKPOOL NORTH AND CLEVELEYS,44302,44264,99.1,53.4,53.3,2.0,2.0,0.0,0.0,0.1,0.8,0.1,99.5,43892,23650,23617,0,8,26,372,890,890,38,44087,0,45.8,53.3,0.0,0.0,0.0,0.0,0.8,20275,23617,0,8,18,346
E14000573,BLACKPOOL SOUTH,45395,45332,98.6,70.1,69.9,0.7,0.7,0.0,0.0,0.0,1.3,0.1,98.7,44754,31844,31733,2,4,11,578,298,298,61,44810,0,28.7,69.9,0.0,0.0,0.0,0.0,1.2,13021,31733,2,2,7,567
E14000574,BLAYDON,44226,43970,92.8,49.0,47.3,6.1,6.1,0.1,0.5,1.8,6.6,0.7,96.6,41063,21665,20936,50,218,802,2907,2684,2684,288,42737,1,45.5,47.3,0.0,0.1,0.4,1.3,4.8,20127,20936,50,168,584,2105
E14000575,BLYTH VALLEY,40691,40648,98.3,30.1,15.1,5.8,5.8,0.0,0.1,0.1,1.6,0.1,99.9,39985,12234,6137,19,26,48,663,2374,2374,45,40638,0,83.2,15.1,0.0,0.0,0.0,0.1,1.5,33848,6137,19,7,22,615
E14000576,BOGNOR REGIS AND LITTLEHAMPTON,51865,51814,97.1,3.6,3.6,3.6,3.6,0.1,0.2,0.3,2.8,0.1,99.5,50374,1854,1854,75,90,144,1440,1854,1854,54,51626,0,93.6,3.6,0.0,0.1,0.0,0.1,2.5,48520,1854,75,15,54,1296
E14000577,BOLSOVER,47887,47805,93.7,35.1,31.3,12.4,12.4,0.1,0.3,0.6,6.1,0.3,98.5,44867,16808,14970,31,137,279,2938,5917,5917,123,47181,0,62.4,31.3,0.0,0.1,0.2,0.3,5.6,29897,14970,31,106,142,2659
E14000578,BOLTON NORTH EAST,47251,47165,99.0,89.0,86.5,1.5,84.4,0.0,0.1,0.3,0.9,0.2,99.4,46757,42031,40855,0,30,160,408,692,39880,85,46983,0,12.5,86.5,0.0,0.0,0.1,0.3,0.5,5902,40855,0,30,130,248
E14000579,BOLTON SOUTH EAST,47412,47328,98.3,86.3,84.5,1.0,82.7,0.0,0.2,0.2,1.5,0.2,98.8,46618,40933,40050,22,88,107,710,491,39201,88,46846,0,13.9,84.5,0.0,0.0,0.1,0.0,1.3,6568,40050,22,66,19,603
E14000580,BOLTON WEST,45891,45846,97.8,82.8,80.8,1.3,80.0,0.0,0.1,0.4,2.1,0.1,99.3,44869,37995,37088,13,31,175,977,593,36727,49,45558,0,17.0,80.8,0.0,0.0,0.0,0.3,1.7,7781,37088,13,18,144,802
E14000581,BOOTLE,49982,49949,99.5,89.2,88.9,42.1,88.9,0.0,0.1,0.1,0.4,0.1,99.6,49744,44574,44441,4,28,44,205,21041,44441,36,49789,0,10.6,88.9,0.0,0.0,0.0,0.0,0.3,5303,44441,4,24,16,161
E14000582,BOSTON AND SKEGNESS,53518,53012,88.6,12.1,7.2,3.8,3.8,0.7,2.3,4.1,10.5,3.0,96.7,47416,6485,3853,393,1214,2195,5596,2039,2039,1620,51748,3353,81.4,7.2,6.3,0.7,1.5,1.8,6.4,43563,3853,393,821,981,3401
E14000583,BOSWORTH,51732,51161,95.2,62.5,59.8,9.7,9.7,0.1,0.9,1.4,3.7,1.2,97.6,49266,32312,30920,49,491,742,1895,5021,5023,616,50471,0,35.5,59.8,0.0,0.1,0.9,0.5,2.2,18346,30920,49,442,251,1153
E14000584,BOURNEMOUTH EAST,51741,51661,98.4,89.9,86.4,16.3,16.3,0.6,0.6,0.8,1.4,0.2,99.5,50916,46536,44680,299,300,435,745,8454,8454,80,51502,0,12.1,86.4,0.0,0.6,0.0,0.3,0.6,6236,44680,299,1,135,310
E14000585,BOURNEMOUTH WEST,52949,52550,98.6,83.2,79.0,42.4,42.4,0.0,0.0,0.0,0.6,0.8,98.7,52225,44075,41844,0,14,25,325,22444,22444,399,52281,0,19.6,79.0,0.0,0.0,0.0,0.0,0.6,10381,41844,0,14,11,300
E14000586,BRACKNELL,49101,48835,95.3,59.2,56.1,7.7,54.2,0.1,0.1,0.9,4.1,0.6,97.8,46814,29078,27562,39,68,431,2021,3785,26622,288,48015,0,39.2,56.1,0.0,0.1,0.1,0.7,3.2,19252,27562,39,29,363,1590
E14000587,BRADFORD EAST,42957,42934,97.6,86.7,86.0,2.3,85.6,0.0,0.1,0.2,2.3,0.1,98.0,41943,37260,36930,0,39,85,991,987,36757,22,42098,3030,11.7,86.0,7.1,0.0,0.1,0.1,2.1,5013,36930,0,39,46,906
E14000588,BRADFORD SOUTH,43725,43717,98.0,85.3,83.9,4.0,82.8,0.0,0.2,0.3,2.0,0.0,99.1,42836,37317,36703,3,70,128,881,1751,36208,8,43313,514,14.0,83.9,1.2,0.0,0.2,0.1,1.7,6133,36703,3,67,58,753
E14000589,BRADFORD WEST,39900,39504,95.1,84.9,83.4,3.0,82.4,0.0,0.2,0.4,3.9,1.0,95.7,37963,33891,33286,6,76,144,1541,1192,32878,396,38175,4153,11.7,83.4,10.4,0.0,0.2,0.2,3.5,4677,33286,6,70,68,1397
E14000590,BRAINTREE,46955,46833,91.8,13.9,13.9,13.9,13.9,0.7,2.2,3.6,7.9,1.9,96.6,43105,6543,6543,324,1018,1674,3728,6513,6513,883,45349,0,77.9,13.9,0.0,0.7,1.5,1.4,4.4,36562,6543,324,694,656,2054
E14000591,BRENT CENTRAL,64175,63877,96.5,61.1,57.6,32.5,32.5,0.0,0.0,0.7,3.1,0.5,96.6,61918,39240,36951,1,22,478,1959,20847,20847,298,62016,0,38.9,57.6,0.0,0.0,0.0,0.7,2.3,24967,36951,1,21,456,1481
E14000592,BRENT NORTH,49122,48908,97.8,81.2,80.1,18.7,18.7,0.0,0.1,0.2,1.8,0.4,97.9,48043,39897,39328,1,49,85,865,9180,9180,208,48066,0,17.7,80.1,0.0,0.0,0.1,0.1,1.6,8715,39328,1,48,36,780
E14000593,BRENTFORD AND ISLEWORTH,55670,55394,97.7,86.1,85.9,15.0,15.0,0.0,0.0,0.2,1.8,0.5,97.8,54402,47950,47840,1,25,87,992,8333,8333,292,54456,0,11.8,85.9,0.0,0.0,0.0,0.1,1.6,6562,47840,1,24,62,905
E14000594,BRENTWOOD AND ONGAR,45381,45250,93.7,19.2,19.2,10.8,10.8,0.1,0.3,0.8,6.0,0.4,97.2,42525,8694,8693,58,132,356,2725,4885,4885,185,44121,0,74.6,19.2,0.0,0.1,0.2,0.5,5.2,33832,8693,58,74,224,2369
E14000595,BRIDGWATER AND WEST SOMERSET,57313,57154,89.3,19.7,10.0,4.5,4.5,1.0,2.6,4.5,10.4,1.4,96.8,51195,11294,5707,571,1499,2603,5959,2577,2577,815,55469,4269,79.4,10.0,7.4,1.0,1.6,1.9,5.9,45488,5707,571,928,1104,3356
E14000596,BRIGG AND GOOLE,41851,41712,92.4,13.3,13.3,10.3,10.3,0.7,1.4,2.0,7.3,0.5,97.7,38666,5550,5547,297,581,818,3046,4299,4299,215,40874,20821,79.1,13.3,49.8,0.7,0.7,0.6,5.3,33119,5547,297,284,237,2228
E14000597,"BRIGHTON, KEMPTOWN",45578,45447,97.7,76.1,75.9,17.5,17.5,0.0,0.0,0.1,2.0,0.3,98.5,44537,34671,34586,0,3,48,910,7975,7975,131,44881,0,21.8,75.9,0.0,0.0,0.0,0.1,1.9,9951,34586,0,3,45,862
E14000598,"BRIGHTON, PAVILION",53669,53584,97.0,86.5,84.4,1.3,1.3,0.0,0.1,1.0,2.8,0.2,97.2,52073,46407,45280,4,62,546,1511,719,719,88,52155,0,12.7,84.4,0.0,0.0,0.1,0.9,1.8,6793,45280,4,58,484,965
E14000599,BRISTOL EAST,46784,46651,97.1,90.9,90.7,43.1,43.1,0.0,0.1,0.6,2.6,0.3,97.2,45435,42522,42428,4,61,279,1216,20185,20185,133,45476,0,6.4,90.7,0.0,0.0,0.1,0.5,2.0,3007,42428,4,57,218,937
E14000600,BRISTOL NORTH WEST,46329,46289,97.7,88.4,85.7,13.3,13.3,0.0,0.1,0.7,2.3,0.2,98.2,45244,40935,39685,2,47,343,1045,6175,6175,84,45477,0,12.0,85.7,0.0,0.0,0.1,0.6,1.5,5559,39685,2,45,296,702
E14000601,BRISTOL SOUTH,52255,52164,98.7,95.7,95.6,76.9,76.9,0.0,0.0,0.2,1.1,0.2,98.8,51599,50002,49966,0,10,80,565,40168,40168,91,51605,0,3.1,95.6,0.0,0.0,0.0,0.1,0.9,1633,49966,0,10,70,485
E14000602,BRISTOL WEST,69451,69265,91.2,82.9,81.0,45.4,45.4,0.0,0.0,0.3,8.5,0.3,91.2,63336,57593,56254,0,0,184,5929,31556,31556,186,63339,0,10.2,81.0,0.0,0.0,0.0,0.3,8.3,7082,56254,0,0,184,5745
E14000603,BROADLAND,48201,47985,90.9,14.9,11.6,8.5,8.5,0.4,1.5,2.9,8.7,2.0,97.7,43810,7159,5578,207,720,1409,4175,4074,4074,961,47090,61,79.3,11.6,0.1,0.4,1.1,1.4,5.7,38232,5578,207,513,689,2766
E14000604,BROMLEY AND CHISLEHURST,42231,42196,97.6,86.6,86.4,4.7,4.7,0.0,0.0,0.2,2.3,0.1,98.5,41217,36578,36507,0,4,69,979,1984,1984,35,41579,0,11.2,86.4,0.0,0.0,0.0,0.2,2.2,4710,36507,0,4,65,910
E14000605,BROMSGROVE,44908,44805,95.9,51.4,51.2,31.1,51.3,0.1,0.5,1.0,3.8,0.4,99.5,43078,23068,22994,45,239,428,1727,13969,23034,161,44669,53,44.7,51.2,0.1,0.1,0.4,0.4,2.9,20084,22994,45,194,189,1299
E14000606,BROXBOURNE,45375,45356,98.5,87.8,84.4,4.0,4.0,0.1,0.1,0.2,1.5,0.1,99.3,44677,39835,38312,26,40,98,679,1821,1821,28,45071,0,14.0,84.4,0.0,0.1,0.0,0.1,1.3,6365,38312,26,14,58,581
E14000607,BROXTOWE,45021,44986,98.8,89.4,83.7,1.5,1.5,0.0,0.1,0.2,1.1,0.1,99.5,44482,40230,37701,14,48,102,504,664,664,34,44816,0,15.1,83.7,0.0,0.0,0.1,0.1,0.9,6781,37701,14,34,54,402
E14000608,BUCKINGHAM,48775,48654,88.8,26.3,22.1,19.2,19.2,0.8,2.6,4.4,11.0,1.1,94.9,43298,12830,10776,414,1256,2166,5356,9344,9344,541,46273,0,66.7,22.1,0.0,0.8,1.7,1.9,6.5,32522,10776,414,842,910,3190
E14000609,BURNLEY,45261,45163,98.1,78.8,78.7,0.9,78.7,0.1,0.1,0.3,1.7,0.2,99.4,44403,35650,35633,34,52,133,760,406,35632,112,44983,2015,19.4,78.7,4.5,0.1,0.0,0.2,1.4,8770,35633,34,18,81,627
E14000610,BURTON,50495,50340,95.3,35.4,30.8,25.7,25.7,0.2,0.6,1.1,4.4,0.5,98.7,48132,17866,15540,108,289,578,2208,12991,12991,238,49863,0,64.5,30.8,0.0,0.2,0.4,0.6,3.2,32592,15540,108,181,289,1630
E14000611,BURY NORTH,42649,42390,97.1,51.1,39.4,8.1,30.7,0.0,0.2,0.3,2.3,0.6,99.3,41410,21813,16805,10,69,113,980,3446,13098,259,42359,0,57.7,39.4,0.0,0.0,0.1,0.1,2.0,24605,16805,10,59,44,867
E14000612,BURY SOUTH,46036,45816,97.6,69.0,68.2,38.1,67.6,0.0,0.0,0.1,1.9,0.5,99.4,44930,31761,31391,4,21,61,886,17558,31126,220,45741,0,29.4,68.2,0.0,0.0,0.0,0.1,1.8,13539,31391,4,17,40,825
E14000613,BURY ST EDMUNDS,56216,56092,94.5,21.8,15.9,11.8,11.8,0.2,0.4,0.8,5.3,0.5,98.9,53111,12250,8929,115,227,456,2981,6651,6651,276,55601,0,78.6,15.9,0.0,0.2,0.2,0.4,4.5,44182,8929,115,112,229,2525
E14000614,CALDER VALLEY,52691,52600,92.5,33.5,33.3,9.1,9.1,0.2,0.6,1.3,7.3,0.3,98.7,48733,17656,17557,93,326,682,3867,4808,4809,144,51994,0,59.2,33.3,0.0,0.2,0.4,0.7,6.0,31176,17557,93,233,356,3185
E14000615,CAMBERWELL AND PECKHAM,57532,57445,95.6,80.1,78.9,35.8,35.8,0.0,0.0,0.2,4.2,0.1,95.7,55014,46059,45390,0,0,142,2431,20578,20578,86,55030,0,16.7,78.9,0.0,0.0,0.0,0.2,4.0,9624,45390,0,0,142,2289
E14000616,CAMBORNE AND REDRUTH,46332,46082,87.9,38.0,38.0,38.0,38.0,0.2,1.1,2.5,11.6,1.0,93.1,40713,17608,17603,95,502,1141,5369,17603,17603,450,43137,0,49.9,38.0,0.0,0.2,0.9,1.4,9.1,23110,17603,95,407,639,4228
E14000617,CAMBRIDGE,56595,56522,98.5,89.4,86.6,21.4,21.4,0.0,0.0,0.2,1.4,0.1,98.5,55744,50580,49008,1,17,113,778,12091,12091,73,55767,269,11.9,86.6,0.5,0.0,0.0,0.2,1.2,6736,49008,1,16,96,665
E14000618,CANNOCK CHASE,47331,47279,97.9,24.8,24.7,3.2,24.5,0.0,0.1,0.1,2.0,0.2,99.6,46322,11720,11676,11,34,40,957,1517,11608,71,47143,0,73.2,24.7,0.0,0.0,0.0,0.0,1.9,34646,11676,11,23,6,917
E14000619,CANTERBURY,53243,53029,93.0,5.2,5.2,5.2,5.2,0.4,0.8,1.6,6.6,0.7,99.1,49522,2760,2760,190,449,844,3507,2760,2760,371,52778,0,87.8,5.2,0.0,0.4,0.5,0.7,5.0,46762,2760,190,259,395,2663
E14000620,CARLISLE,45703,45559,96.8,62.1,55.5,4.4,4.4,0.2,0.5,1.5,2.9,0.5,98.1,44236,28376,25345,75,234,670,1323,2024,2024,232,44855,0,41.3,55.5,0.0,0.2,0.3,1.0,1.4,18891,25345,75,159,436,653
E14000621,CARSHALTON AND WALLINGTON,42926,42866,98.0,84.4,83.4,4.9,4.9,0.0,0.0,0.5,1.9,0.1,98.4,42069,36235,35792,13,16,229,797,2101,2101,60,42248,0,14.6,83.4,0.0,0.0,0.0,0.5,1.3,6277,35792,13,3,213,568
E14000622,CASTLE POINT,41031,40805,98.5,43.6,43.6,2.2,2.2,0.0,0.2,0.3,0.9,0.6,99.2,40416,17904,17888,4,82,115,389,917,917,226,40687,0,54.9,43.6,0.0,0.0,0.2,0.1,0.7,22528,17888,4,78,33,274
E14000623,CENTRAL DEVON,45295,45072,77.7,18.1,17.9,16.4,16.4,1.9,5.5,10.7,21.8,2.4,92.7,35177,8191,8101,843,2498,4843,9895,7427,7427,1094,41969,23205,59.8,17.9,51.2,1.9,3.7,5.2,11.2,27076,8101,843,1655,2345,5052
E14000624,CENTRAL SUFFOLK AND NORTH IPSWICH,47023,46884,92.3,37.4,35.6,14.0,14.0,0.4,1.0,2.2,7.4,1.0,98.3,43418,17601,16724,173,453,1037,3466,6598,6598,454,46214,0,56.8,35.6,0.0,0.4,0.6,1.2,5.2,26694,16724,173,280,584,2429
E14000625,CHARNWOOD,45692,45658,98.1,75.1,73.2,13.5,13.5,0.0,0.1,0.3,1.8,0.1,99.4,44823,34317,33426,17,58,159,835,6186,6186,59,45435,0,24.9,73.2,0.0,0.0,0.1,0.2,1.5,11397,33426,17,41,101,676
E14000626,CHATHAM AND AYLESFORD,43825,43789,98.6,86.9,83.4,6.2,6.2,0.0,0.1,0.4,1.3,0.1,99.3,43214,38094,36568,7,38,154,575,2711,2711,39,43521,0,15.2,83.4,0.0,0.0,0.1,0.3,1.0,6646,36568,7,31,116,421
E14000627,CHEADLE,42679,42582,98.2,77.7,77.6,4.2,47.4,0.0,0.0,0.0,1.6,0.2,99.1,41907,33143,33130,1,5,15,675,1775,20248,96,42311,0,20.6,77.6,0.0,0.0,0.0,0.0,1.5,8777,33130,1,4,10,660
E14000628,CHELMSFORD,51787,51747,98.0,82.4,79.0,43.7,43.7,0.0,0.0,0.0,1.9,0.1,98.7,50777,42676,40906,2,14,23,970,22652,22652,39,51100,0,19.1,79.0,0.0,0.0,0.0,0.0,1.8,9871,40906,2,12,9,947
E14000629,CHELSEA AND FULHAM,60915,60781,94.7,72.2,61.1,18.2,18.2,0.0,0.0,0.0,5.1,0.2,94.7,57676,43991,37247,0,0,7,3105,11058,11058,128,57682,0,33.5,61.1,0.0,0.0,0.0,0.0,5.1,20429,37247,0,0,7,3098
E14000630,CHELTENHAM,54446,54314,98.6,77.3,70.5,5.1,5.1,0.0,0.1,0.2,1.1,0.2,99.1,53707,42064,38404,8,41,121,607,2799,2799,135,53944,0,28.1,70.5,0.0,0.0,0.1,0.1,0.9,15303,38404,8,33,80,486
E14000631,CHESHAM AND AMERSHAM,42769,42755,93.8,45.1,44.5,1.9,1.9,0.0,0.2,2.0,6.2,0.1,99.6,40107,19293,19027,18,75,867,2648,811,816,52,42615,0,49.3,44.5,0.0,0.0,0.1,1.9,4.2,21080,19027,18,57,792,1781
E14000632,CHESTERFIELD,48032,47979,97.7,53.8,39.8,20.2,20.2,0.0,0.0,0.2,2.2,0.1,99.4,46913,25846,19136,0,12,109,1066,9723,9723,55,47741,0,57.8,39.8,0.0,0.0,0.0,0.2,2.0,27777,19136,0,12,97,957
E14000633,CHICHESTER,57089,56733,91.5,23.8,21.6,20.0,20.0,0.3,0.8,1.8,7.9,1.2,98.6,52234,13602,12343,197,483,1001,4499,11443,11443,705,56316,0,69.9,21.6,0.0,0.3,0.5,0.9,6.1,39891,12343,197,286,518,3498
E14000634,CHINGFORD AND WOODFORD GREEN,39563,39529,97.0,86.0,85.4,9.9,9.9,0.0,0.0,0.4,3.0,0.1,97.2,38360,34032,33792,7,9,177,1169,3928,3928,49,38447,0,11.5,85.4,0.0,0.0,0.0,0.4,2.5,4568,33792,7,2,168,992
E14000635,CHIPPENHAM,47051,47004,95.4,37.5,31.8,12.0,12.0,0.1,0.3,0.6,4.5,0.2,98.9,44872,17635,14956,58,155,293,2132,5646,5646,82,46538,0,63.6,31.8,0.0,0.1,0.2,0.3,3.9,29916,14956,58,97,138,1839
E14000636,CHIPPING BARNET,48919,48868,97.3,60.2,54.6,41.8,41.8,0.0,0.0,0.2,2.6,0.1,98.2,47614,29458,26704,0,5,89,1254,20456,20456,49,48015,0,42.7,54.6,0.0,0.0,0.0,0.2,2.4,20910,26704,0,5,84,1165
E14000637,CHORLEY,49447,49339,95.8,59.6,56.0,8.6,8.6,0.1,0.2,0.7,4.0,0.3,99.1,47353,29471,27680,29,113,356,1986,4240,4241,126,48998,2546,39.8,56.0,5.1,0.1,0.2,0.5,3.3,19673,27680,29,84,243,1630
E14000638,CHRISTCHURCH,44259,44023,95.7,43.9,43.8,14.8,14.8,0.1,0.1,0.2,3.7,0.6,99.2,42364,19444,19379,42,63,82,1659,6561,6562,264,43920,0,51.9,43.8,0.0,0.1,0.0,0.0,3.6,22985,19379,42,21,19,1577
E14000639,CITIES OF LONDON AND WESTMINSTER,112710,112273,79.8,62.6,61.7,57.9,57.9,0.0,0.0,0.0,19.8,0.4,79.8,89967,70522,69547,0,0,54,22306,65261,65261,428,89980,0,18.1,61.7,0.0,0.0,0.0,0.0,19.7,20420,69547,0,0,54,22252
E14000640,CITY OF CHESTER,48539,48468,96.0,47.3,34.0,23.7,23.7,0.1,0.2,0.8,3.8,0.2,98.4,46621,22951,16519,46,111,387,1847,11527,11527,87,47755,25,62.0,34.0,0.1,0.1,0.1,0.6,3.0,30102,16519,46,65,276,1460
E14000641,CITY OF DURHAM,44806,44726,94.3,2.2,2.0,1.8,1.8,0.1,0.2,0.3,5.5,0.4,98.2,42261,966,889,35,86,134,2465,820,820,158,44019,0,92.3,2.0,0.0,0.1,0.1,0.1,5.2,41372,889,35,51,48,2331
E14000642,CLACTON,47274,47208,97.9,6.1,6.1,6.1,6.1,0.1,0.3,0.5,2.0,0.3,99.7,46268,2891,2891,65,127,237,940,2891,2891,129,47154,0,91.8,6.1,0.0,0.1,0.1,0.2,1.5,43377,2891,65,62,110,703
E14000643,CLEETHORPES,44683,44596,94.1,65.1,65.1,1.4,1.4,0.3,1.6,2.4,5.8,0.6,96.6,42025,29110,29076,140,718,1088,2571,633,633,289,43186,12502,29.0,65.1,28.0,0.3,1.3,0.8,3.3,12949,29076,140,578,370,1483
E14000644,COLCHESTER,56694,56510,98.4,70.0,69.7,5.5,5.5,0.0,0.0,0.2,1.3,0.3,98.9,55797,39663,39533,5,17,91,713,3105,3105,188,56083,0,28.7,69.7,0.0,0.0,0.0,0.1,1.1,16264,39533,5,12,74,622
E14000645,COLNE VALLEY,52734,52686,95.4,55.2,55.1,13.2,13.2,0.1,0.5,1.3,4.5,0.1,98.8,50325,29124,29061,65,239,672,2361,6969,6969,66,52101,0,40.3,55.1,0.0,0.1,0.3,0.8,3.2,21264,29061,65,174,433,1689
E14000646,CONGLETON,49069,49019,93.3,35.2,27.3,21.2,21.2,0.1,0.5,0.9,6.6,0.2,99.0,45769,17283,13401,73,225,459,3250,10392,10392,102,48567,0,66.0,27.3,0.0,0.1,0.3,0.5,5.7,32368,13401,73,152,234,2791
E14000647,COPELAND,42126,41984,93.7,1.8,1.8,1.8,1.8,0.5,1.2,2.1,6.0,1.3,98.9,39451,746,746,217,489,890,2533,746,746,559,41647,1122,91.9,1.8,2.7,0.5,0.6,1.0,3.9,38705,746,217,272,401,1643
E14000648,CORBY,56665,56556,97.8,63.6,56.0,21.6,21.6,0.1,0.3,0.5,2.0,0.4,98.7,55430,36051,31757,49,176,289,1126,12230,12230,242,55934,0,41.8,56.0,0.0,0.1,0.2,0.2,1.5,23673,31757,49,127,113,837
E14000649,COVENTRY NORTH EAST,53177,52937,98.4,92.9,92.8,50.9,92.8,0.0,0.2,0.4,1.2,0.4,98.4,52302,49391,49332,2,108,211,635,27081,49332,235,52336,0,5.6,92.8,0.0,0.0,0.2,0.2,0.8,2970,49332,2,106,103,424
E14000650,COVENTRY NORTH WEST,47229,47178,98.4,92.4,92.1,81.5,92.1,0.0,0.2,0.6,1.5,0.1,98.7,46452,43619,43495,5,91,260,726,38491,43501,55,46616,0,6.3,92.1,0.0,0.0,0.2,0.4,1.0,2957,43495,5,86,169,466
E14000651,COVENTRY SOUTH,48108,47919,96.0,82.9,82.8,71.1,82.9,0.0,0.5,0.8,3.6,0.4,96.2,46187,39886,39818,0,259,384,1732,34226,39863,187,46265,0,13.2,82.8,0.0,0.0,0.5,0.3,2.8,6369,39818,0,259,125,1348
E14000652,CRAWLEY,49058,48883,98.6,84.6,84.0,3.0,3.0,0.0,0.1,0.2,1.0,0.4,99.1,48383,41525,41222,10,35,89,500,1448,1448,183,48620,0,14.6,84.0,0.0,0.0,0.1,0.1,0.8,7161,41222,10,25,54,411
E14000653,CREWE AND NANTWICH,53295,53206,95.6,26.9,13.0,2.7,2.7,0.0,0.2,0.5,4.2,0.2,98.5,50960,14335,6941,14,105,274,2246,1446,1446,128,52477,1069,82.6,13.0,2.0,0.0,0.2,0.3,3.7,44019,6941,14,91,169,1972
E14000654,CROYDON CENTRAL,55805,55201,96.2,82.8,81.1,14.3,14.3,0.0,0.0,0.0,2.8,1.1,96.8,53665,46199,45234,1,3,20,1536,8001,8001,612,54024,0,15.1,81.1,0.0,0.0,0.0,0.0,2.7,8431,45234,1,2,17,1516
E14000655,CROYDON NORTH,61855,61768,95.7,88.0,86.9,36.9,36.9,0.0,0.0,0.3,4.1,0.1,95.9,59219,54421,53735,0,8,184,2549,22833,22833,87,59296,0,8.9,86.9,0.0,0.0,0.0,0.3,3.8,5484,53735,0,8,176,2365
E14000656,CROYDON SOUTH,50340,50272,96.0,80.6,80.4,5.0,5.0,0.0,0.1,0.4,3.8,0.1,97.1,48347,40596,40458,0,47,189,1925,2511,2511,62,48902,0,15.7,80.4,0.0,0.0,0.1,0.3,3.4,7889,40458,0,47,142,1736
E14000657,DAGENHAM AND RAINHAM,46292,45517,95.5,84.8,84.6,35.5,35.5,0.0,0.4,0.8,2.8,1.9,95.9,44219,39242,39148,17,172,359,1298,16440,16440,892,44390,0,11.0,84.6,0.0,0.0,0.3,0.4,2.0,5071,39148,17,155,187,939
E14000658,DARLINGTON,47501,47446,98.0,90.4,90.0,1.1,1.1,0.1,0.8,1.2,1.9,0.2,98.2,46555,42933,42740,57,398,573,891,540,540,92,46634,9886,8.0,90.0,20.8,0.1,0.7,0.4,0.7,3815,42740,57,341,175,318
E14000659,DARTFORD,51761,51731,95.2,52.1,48.4,14.0,14.0,0.2,0.5,1.3,4.7,0.1,98.3,49294,26947,25030,94,284,687,2437,7225,7225,40,50899,0,46.9,48.4,0.0,0.2,0.4,0.8,3.4,24264,25030,94,190,403,1750
E14000660,DAVENTRY,46181,46122,94.4,38.6,33.0,23.4,23.4,0.3,1.0,2.0,5.4,0.3,97.7,43608,17812,15230,131,469,910,2514,10785,10785,154,45129,308,61.4,33.0,0.7,0.3,0.7,1.0,3.5,28378,15230,131,338,441,1604
E14000661,DENTON AND REDDISH,43855,43805,98.4,86.2,84.2,10.2,12.4,0.0,0.1,0.2,1.5,0.1,99.4,43168,37809,36942,0,40,73,637,4483,5459,50,43577,0,14.2,84.2,0.0,0.0,0.1,0.1,1.3,6226,36942,0,40,33,564
E14000662,DERBY NORTH,48568,48145,98.5,88.9,87.6,5.7,5.8,0.0,0.0,0.2,0.6,0.9,98.8,47856,43184,42569,0,0,81,289,2758,2797,423,47995,0,10.9,87.6,0.0,0.0,0.0,0.2,0.4,5287,42569,0,0,81,208
E14000663,DERBY SOUTH,52114,51995,98.9,90.8,90.2,11.9,11.9,0.0,0.0,0.1,0.8,0.2,99.1,51559,47300,47016,0,14,32,436,6223,6223,119,51637,0,8.7,90.2,0.0,0.0,0.0,0.0,0.8,4543,47016,0,14,18,404
E14000664,DERBYSHIRE DALES,41569,41428,87.9,10.0,9.9,8.9,8.9,0.5,2.2,4.6,11.7,1.6,96.2,36551,4165,4097,227,911,1900,4877,3705,3705,666,39981,0,78.1,9.9,0.0,0.5,1.6,2.4,7.2,32454,4097,227,684,989,2977
E14000665,DEVIZES,45476,45414,92.8,25.2,25.2,7.6,7.6,0.1,0.7,1.9,7.1,0.7,98.5,42188,11476,11473,60,327,873,3226,3471,3471,309,44788,0,67.5,25.2,0.0,0.1,0.6,1.2,5.2,30715,11473,60,267,546,2353
E14000666,DEWSBURY,48461,48421,96.9,60.4,60.4,15.1,15.1,0.0,0.1,0.6,3.0,0.1,98.7,46952,29288,29271,6,63,267,1469,7299,7299,49,47843,0,36.5,60.4,0.0,0.0,0.1,0.4,2.5,17681,29271,6,57,204,1202
E14000667,DON VALLEY,47016,46962,96.7,44.6,44.5,29.0,29.0,0.1,0.3,0.8,3.1,0.2,98.9,45483,20960,20908,27,156,371,1479,13638,13638,76,46480,7124,52.3,44.5,15.2,0.1,0.3,0.5,2.4,24575,20908,27,129,215,1108
E14000668,DONCASTER CENTRAL,52372,52309,98.0,68.0,67.9,25.2,25.2,0.0,0.1,0.3,1.9,0.1,98.6,51332,35599,35567,6,63,138,977,13185,13186,77,51639,10343,30.1,67.9,19.7,0.0,0.1,0.1,1.6,15765,35567,6,57,75,839
E14000669,DONCASTER NORTH,47001,46954,97.7,58.0,57.2,21.4,21.4,0.2,0.4,0.6,2.2,0.1,99.5,45900,27251,26873,77,208,269,1054,10069,10069,64,46780,3938,40.5,57.2,8.4,0.2,0.3,0.1,1.7,19027,26873,77,131,61,785
E14000670,DOVER,48504,48430,94.5,35.2,35.2,4.7,4.7,0.5,0.9,1.4,5.4,0.3,98.8,45818,17097,17093,262,420,659,2612,2270,2270,142,47921,0,59.2,35.2,0.0,0.5,0.3,0.5,4.0,28725,17093,262,158,239,1953
E14000671,DUDLEY NORTH,38002,37941,99.0,90.0,89.0,1.2,79.1,0.0,0.0,0.0,0.9,0.2,99.3,37613,34204,33811,0,0,13,328,445,30070,61,37746,2531,10.0,89.0,6.7,0.0,0.0,0.0,0.8,3802,33811,0,0,13,315
E14000672,DUDLEY SOUTH,38464,38392,98.9,89.8,88.3,1.4,86.7,0.0,0.0,0.1,0.9,0.2,99.1,38041,34554,33966,0,7,37,351,530,33332,72,38108,3789,10.6,88.3,9.9,0.0,0.0,0.1,0.8,4075,33966,0,7,30,314
E14000673,DULWICH AND WEST NORWOOD,52433,52310,96.6,73.8,69.8,5.2,5.2,0.0,0.0,0.0,3.1,0.2,96.7,50666,38712,36598,0,0,0,1644,2742,2742,119,50699,0,26.8,69.8,0.0,0.0,0.0,0.0,3.1,14068,36598,0,0,0,1644
E14000674,EALING CENTRAL AND ACTON,60722,60681,98.2,84.2,82.2,13.7,13.7,0.0,0.0,0.3,1.7,0.1,98.2,59634,51105,49910,0,18,205,1047,8313,8313,39,59642,0,16.0,82.2,0.0,0.0,0.0,0.3,1.4,9724,49910,0,18,187,842
E14000675,EALING NORTH,49153,49100,99.0,85.7,83.8,17.5,17.5,0.0,0.0,0.6,0.9,0.1,99.1,48671,42110,41212,0,20,273,429,8623,8623,43,48693,0,15.2,83.8,0.0,0.0,0.0,0.5,0.3,7459,41212,0,20,253,156
E14000676,"EALING, SOUTHALL",38066,38026,98.0,48.2,46.7,17.0,17.0,0.0,0.0,0.1,1.9,0.1,98.1,37315,18351,17758,0,1,49,711,6461,6461,39,37324,0,51.4,46.7,0.0,0.0,0.0,0.1,1.7,19557,17758,0,1,48,662
E14000677,EASINGTON,41237,41202,96.3,37.6,26.4,17.1,17.1,0.1,0.2,0.4,3.7,0.1,99.8,39696,15486,10897,29,78,166,1506,7056,7056,49,41143,0,69.8,26.4,0.0,0.1,0.1,0.2,3.2,28799,10897,29,49,88,1340
E14000678,EAST DEVON,54109,54013,90.1,32.1,26.7,17.3,17.3,0.4,1.7,3.3,9.7,0.5,96.4,48746,17370,14427,241,943,1789,5267,9338,9338,267,52174,14268,63.4,26.7,26.4,0.4,1.3,1.6,6.4,34319,14427,241,702,846,3478
E14000679,EAST HAM,55213,55154,97.0,79.4,73.7,17.0,17.0,0.0,0.1,0.9,2.9,0.1,97.0,53531,43858,40698,2,68,483,1623,9403,9403,64,53542,0,23.2,73.7,0.0,0.0,0.1,0.8,2.1,12833,40698,2,66,415,1140
E14000680,EAST HAMPSHIRE,47627,47331,91.6,35.9,31.4,12.8,12.8,0.2,0.6,1.4,7.8,1.1,96.7,43609,17107,14957,98,302,687,3722,6105,6105,532,46059,0,60.2,31.4,0.0,0.2,0.4,0.8,6.4,28652,14957,98,204,385,3035
E14000681,EAST SURREY,49914,49855,94.9,58.2,56.8,11.2,11.2,0.1,0.4,0.8,5.0,0.2,99.6,47352,29046,28351,43,215,399,2503,5587,5587,115,49711,0,38.1,56.8,0.0,0.1,0.3,0.4,4.2,19001,28351,43,172,184,2104
E14000682,EAST WORTHING AND SHOREHAM,45205,45171,98.9,88.2,88.0,13.6,13.6,0.0,0.0,0.1,1.0,0.1,99.5,44718,39876,39789,0,10,34,453,6160,6160,43,44998,0,10.9,88.0,0.0,0.0,0.0,0.1,0.9,4929,39789,0,10,24,419
E14000683,EAST YORKSHIRE,52519,52435,93.9,36.3,31.9,28.9,28.9,0.6,1.4,2.3,5.9,0.4,99.0,49331,19040,16768,305,733,1197,3104,15190,15190,222,51989,22900,62.0,31.9,43.6,0.6,0.8,0.9,3.6,32563,16768,305,428,464,1907
E14000684,EASTBOURNE,54460,54430,98.7,2.8,2.8,2.8,2.8,0.0,0.0,0.1,1.2,0.1,99.4,53768,1527,1527,1,7,58,662,1527,1527,32,54160,0,95.9,2.8,0.0,0.0,0.0,0.1,1.1,52241,1527,1,6,51,604
E14000685,EASTLEIGH,51022,50946,97.4,75.7,65.3,17.5,24.1,0.0,0.0,0.1,2.5,0.2,99.1,49672,38646,33338,0,0,58,1274,8932,12275,78,50558,0,32.0,65.3,0.0,0.0,0.0,0.1,2.4,16334,33338,0,0,58,1216
E14000686,EDDISBURY,44086,43978,89.0,44.2,41.3,39.6,39.6,0.9,2.7,4.5,10.7,0.7,97.4,39256,19507,18188,405,1212,1972,4722,17464,17464,329,42926,2456,47.8,41.3,5.6,0.9,1.8,1.7,6.2,21068,18188,405,807,760,2750
E14000687,EDMONTON,45169,44912,96.9,89.3,88.3,3.2,3.2,0.0,0.1,0.8,2.5,0.6,96.9,43764,40321,39905,0,54,376,1148,1451,1451,256,43781,0,8.5,88.3,0.0,0.0,0.1,0.7,1.7,3859,39905,0,54,322,772
E14000688,ELLESMERE PORT AND NESTON,43934,43904,97.3,60.2,59.8,7.0,7.0,0.1,0.2,0.2,2.7,0.1,99.4,42726,26465,26264,29,67,96,1178,3081,3081,40,43649,0,37.5,59.8,0.0,0.1,0.1,0.1,2.5,16462,26264,29,38,29,1082
E14000689,ELMET AND ROTHWELL,48213,48141,94.1,63.5,62.1,47.1,61.0,0.2,0.8,1.6,5.7,0.4,97.3,45388,30634,29947,107,381,755,2753,22715,29422,212,46927,285,32.0,62.1,0.6,0.2,0.6,0.8,4.1,15441,29947,107,274,374,1998
E14000690,ELTHAM,40538,40526,99.3,88.6,85.6,4.8,4.8,0.0,0.0,0.0,0.7,0.0,99.5,40258,35927,34690,0,10,16,268,1959,1959,12,40319,0,13.7,85.6,0.0,0.0,0.0,0.0,0.6,5568,34690,0,10,6,252
E14000691,ENFIELD NORTH,44765,44434,97.9,90.4,89.3,3.5,3.5,0.1,0.1,0.5,1.4,0.7,98.3,43809,40464,39986,30,62,202,625,1573,1573,330,44008,0,8.5,89.3,0.0,0.1,0.1,0.3,0.9,3823,39986,30,32,140,423
E14000692,"ENFIELD, SOUTHGATE",42949,42404,96.9,84.1,82.7,1.9,1.9,0.0,0.0,0.1,1.8,1.4,97.5,41620,36125,35498,0,0,55,784,812,812,588,41879,0,14.3,82.7,0.0,0.0,0.0,0.1,1.7,6122,35498,0,0,55,729
E14000693,EPPING FOREST,45940,45896,96.9,80.0,78.3,4.0,4.0,0.1,0.4,1.0,3.0,0.4,99.0,44527,36731,35992,34,174,458,1369,1853,1853,164,45483,0,18.6,78.3,0.0,0.1,0.3,0.6,2.0,8535,35992,34,140,284,911
E14000694,EPSOM AND EWELL,45955,45917,99.3,89.4,89.3,54.7,54.7,0.0,0.1,0.1,0.6,0.1,99.7,45648,41097,41046,0,42,61,269,25149,25149,65,45825,0,10.0,89.3,0.0,0.0,0.1,0.0,0.5,4602,41046,0,42,19,208
E14000695,EREWASH,47360,47265,98.8,81.0,80.4,1.0,1.0,0.0,0.1,0.2,1.0,0.2,99.6,46810,38365,38055,6,38,78,455,494,494,97,47166,0,18.5,80.4,0.0,0.0,0.1,0.1,0.8,8755,38055,6,32,40,377
E14000696,ERITH AND THAMESMEAD,46351,46294,98.0,80.8,79.0,38.8,38.8,0.0,0.3,1.1,1.9,0.2,98.0,45422,37463,36623,1,138,493,872,18003,18003,90,45440,0,19.0,79.0,0.0,0.0,0.3,0.8,0.8,8799,36623,1,137,355,379
E14000697,ESHER AND WALTON,49682,49610,98.8,81.3,79.8,4.3,4.3,0.0,0.0,0.1,1.0,0.1,99.7,49102,40368,39625,3,16,44,508,2120,2120,69,49539,0,19.1,79.8,0.0,0.0,0.0,0.1,0.9,9477,39625,3,13,28,464
E14000698,EXETER,50645,50567,96.5,87.9,87.6,65.5,65.5,0.1,0.2,1.6,3.3,0.2,96.8,48878,44501,44359,31,104,791,1689,33157,33157,97,49045,16286,8.9,87.6,32.2,0.1,0.1,1.4,1.8,4519,44359,31,73,687,898
E14000699,FAREHAM,46230,46175,98.1,85.7,82.9,5.9,6.0,0.0,0.2,0.5,1.8,0.1,99.4,45350,39598,38319,7,91,227,825,2742,2785,56,45947,0,15.2,82.9,0.0,0.0,0.2,0.3,1.3,7031,38319,7,84,136,598
E14000700,FAVERSHAM AND MID KENT,45145,44891,89.7,39.8,37.7,12.8,12.8,0.8,1.9,3.6,9.8,1.5,97.9,40489,17990,17013,383,875,1604,4402,5794,5794,692,44209,0,52.0,37.7,0.0,0.8,1.1,1.6,6.2,23476,17013,383,492,729,2798
E14000701,FELTHAM AND HESTON,44798,44748,97.5,85.2,85.2,6.9,6.9,0.0,0.1,0.5,2.4,0.1,97.5,43666,38161,38148,0,49,220,1082,3089,3089,50,43689,0,12.3,85.2,0.0,0.0,0.1,0.4,1.9,5518,38148,0,49,171,862
E14000702,FILTON AND BRADLEY STOKE,45850,45765,98.3,79.9,78.2,12.2,12.2,0.0,0.1,0.6,1.5,0.1,99.0,45087,36613,35863,10,35,288,678,5608,5608,66,45379,0,20.1,78.2,0.0,0.0,0.1,0.6,0.9,9224,35863,10,25,253,390
E14000703,FINCHLEY AND GOLDERS GREEN,52994,52929,97.6,61.0,55.6,7.9,7.9,0.0,0.0,0.0,2.3,0.1,98.4,51703,32344,29467,0,1,5,1226,4205,4205,65,52153,0,42.0,55.6,0.0,0.0,0.0,0.0,2.3,22236,29467,0,1,4,1221
E14000704,FOLKESTONE AND HYTHE,56805,56741,92.2,39.4,39.2,5.1,5.1,0.5,1.4,2.8,7.7,0.6,97.6,52357,22389,22289,287,776,1593,4384,2911,2911,342,55467,0,52.9,39.2,0.0,0.5,0.9,1.4,4.9,30068,22289,287,489,817,2791
E14000705,FOREST OF DEAN,43691,43546,80.1,23.5,21.1,19.4,19.4,0.6,3.1,7.9,19.6,2.4,88.8,34980,10265,9223,256,1335,3433,8566,8489,8489,1044,38787,711,59.0,21.1,1.6,0.6,2.5,4.8,11.7,25757,9223,256,1079,2098,5133
E14000706,FYLDE,39477,39232,93.4,46.5,36.6,7.2,7.3,0.1,0.3,0.9,5.9,0.6,98.1,36888,18375,14446,27,120,338,2344,2842,2864,247,38743,7,56.8,36.6,0.0,0.1,0.2,0.6,5.1,22442,14446,27,93,218,2006
E14000707,GAINSBOROUGH,47464,47212,85.5,31.8,29.7,18.3,18.3,2.1,4.6,7.1,13.9,1.6,97.0,40592,15102,14102,1016,2166,3358,6620,8667,8667,750,46050,12139,55.8,29.7,25.6,2.1,2.4,2.5,6.9,26490,14102,1016,1150,1192,3262
E14000708,GARSTON AND HALEWOOD,47250,47229,99.0,73.7,73.4,24.6,73.4,0.0,0.1,0.2,1.0,0.0,99.5,46780,34828,34685,5,26,95,449,11608,34664,23,47032,0,25.6,73.4,0.0,0.0,0.0,0.1,0.7,12095,34685,5,21,69,354
E14000709,GATESHEAD,48475,48413,97.8,87.1,85.1,2.9,2.9,0.0,0.0,0.5,2.1,0.1,97.9,47400,42242,41235,0,8,243,1013,1419,1419,64,47440,0,12.7,85.1,0.0,0.0,0.0,0.5,1.6,6165,41235,0,8,235,770
E14000710,GEDLING,45032,44938,99.5,93.0,92.2,43.8,43.8,0.0,0.1,0.1,0.3,0.2,99.7,44785,41883,41536,2,31,41,153,19709,19709,98,44888,0,7.2,92.2,0.0,0.0,0.1,0.0,0.2,3249,41536,2,29,10,112
E14000711,GILLINGHAM AND RAINHAM,44009,43981,98.6,91.4,89.8,1.6,1.6,0.0,0.1,0.3,1.3,0.1,99.4,43388,40220,39523,3,65,151,593,711,711,31,43752,0,8.8,89.8,0.0,0.0,0.1,0.2,1.0,3865,39523,3,62,86,442
E14000712,GLOUCESTER,55767,55731,98.6,85.0,84.1,8.4,8.4,0.0,0.1,0.4,1.3,0.1,99.1,54999,47429,46916,1,46,211,732,4707,4707,50,55289,0,14.5,84.1,0.0,0.0,0.1,0.3,0.9,8083,46916,1,45,165,521
E14000713,GOSPORT,45225,45207,99.6,85.5,85.2,1.3,1.3,0.0,0.0,0.0,0.3,0.0,99.9,45063,38686,38537,1,9,9,144,588,588,18,45195,0,14.4,85.2,0.0,0.0,0.0,0.0,0.3,6526,38537,1,8,0,135
E14000714,GRANTHAM AND STAMFORD,54263,54190,93.9,38.4,36.0,4.5,4.5,0.7,1.1,1.8,6.0,0.4,98.8,50930,20853,19540,390,611,982,3260,2416,2416,213,53592,0,57.8,36.0,0.0,0.7,0.4,0.7,4.2,31390,19540,390,221,371,2278
E14000715,GRAVESHAM,45112,45040,96.0,71.1,64.8,6.4,6.4,0.0,0.3,0.6,3.9,0.3,98.6,43298,32075,29245,22,129,286,1742,2908,2908,128,44460,0,31.2,64.8,0.0,0.0,0.2,0.3,3.2,14053,29245,22,107,157,1456
E14000716,GREAT GRIMSBY,40681,40634,98.0,89.8,89.1,0.3,0.3,0.0,0.1,0.3,1.9,0.2,98.4,39852,36551,36246,1,38,140,782,119,119,67,40010,11039,8.9,89.1,27.1,0.0,0.1,0.3,1.6,3606,36246,1,37,102,642
E14000717,GREAT YARMOUTH,49281,49082,97.0,50.1,50.1,3.3,3.3,0.0,0.2,0.4,2.6,0.5,99.3,47815,24701,24691,9,74,175,1267,1625,1625,234,48943,0,46.9,50.1,0.0,0.0,0.1,0.2,2.2,23124,24691,9,65,101,1092
E14000718,GREENWICH AND WOOLWICH,63818,63669,97.0,76.7,67.4,24.4,24.4,0.0,0.2,1.0,2.8,0.2,97.1,61896,48921,42983,0,123,651,1773,15547,15547,150,61982,0,29.6,67.4,0.0,0.0,0.2,0.8,1.8,18913,42983,0,123,528,1122
E14000719,GUILDFORD,46283,46238,95.7,68.1,65.6,4.8,4.8,0.1,0.4,1.0,4.2,0.3,98.9,44280,31502,30366,48,168,458,1958,2205,2206,161,45796,0,30.1,65.6,0.0,0.1,0.3,0.6,3.2,13914,30366,48,120,290,1500
E14000720,HACKNEY NORTH AND STOKE NEWINGTON,59209,59142,98.7,84.7,80.4,11.3,11.3,0.0,0.0,0.0,1.2,0.1,98.7,58458,50142,47627,0,0,1,684,6670,6670,67,58459,0,18.3,80.4,0.0,0.0,0.0,0.0,1.2,10831,47627,0,0,1,683
E14000721,HACKNEY SOUTH AND SHOREDITCH,66346,65867,95.8,69.0,64.0,25.7,25.7,0.0,0.0,0.4,3.4,0.7,95.9,63590,45746,42484,0,0,235,2277,17029,17029,476,63611,0,31.8,64.0,0.0,0.0,0.0,0.4,3.1,21106,42484,0,0,235,2042
E14000722,HALESOWEN AND ROWLEY REGIS,41487,41449,99.5,92.4,90.5,1.2,88.8,0.0,0.0,0.1,0.4,0.1,99.6,41265,38341,37531,0,2,37,184,509,36832,38,41326,1,9.0,90.5,0.0,0.0,0.0,0.1,0.4,3734,37531,0,2,35,147
E14000723,HALIFAX,51069,50970,97.7,65.4,64.6,12.2,12.2,0.0,0.1,0.2,2.1,0.2,98.8,49881,33375,32982,7,61,110,1089,6220,6220,99,50453,3,33.1,64.6,0.0,0.0,0.1,0.1,1.9,16899,32982,7,54,49,979
E14000724,HALTEMPRICE AND HOWDEN,41847,41491,96.1,72.6,72.6,72.6,72.6,0.4,0.7,1.1,3.0,0.1,98.4,40234,30368,30366,175,291,441,1257,30365,30365,53,41182,10763,23.6,72.6,25.7,0.4,0.3,0.4,1.9,9868,30366,175,116,150,816
E14000725,HALTON,47784,47594,97.8,67.8,67.2,2.1,3.0,0.0,0.1,0.3,1.8,0.4,99.2,46736,32396,32131,2,29,141,858,990,1440,192,47395,0,30.6,67.2,0.0,0.0,0.1,0.2,1.5,14605,32131,2,27,112,717
E14000726,HAMMERSMITH,58594,58459,95.1,73.1,64.9,22.4,22.4,0.0,0.1,0.3,4.7,0.2,95.1,55726,42854,38004,0,63,199,2733,13106,13140,135,55743,0,30.2,64.9,0.0,0.0,0.1,0.2,4.3,17722,38004,0,63,136,2534
E14000727,HAMPSTEAD AND KILBURN,65756,65623,98.8,83.4,82.9,22.9,22.9,0.0,0.0,0.1,1.0,0.2,98.8,64944,54815,54531,0,0,39,679,15072,15072,133,64947,0,15.8,82.9,0.0,0.0,0.0,0.1,1.0,10413,54531,0,0,39,640
E14000728,HARBOROUGH,48439,48360,97.8,63.8,59.5,3.6,3.6,0.1,0.1,0.3,2.0,0.2,99.4,47394,30914,28798,29,57,138,966,1748,1748,99,48142,0,38.4,59.5,0.0,0.1,0.1,0.2,1.7,18596,28798,29,28,81,828
E14000729,HARLOW,46934,46743,94.7,87.4,85.5,9.5,9.5,0.0,0.2,0.7,4.9,0.4,95.6,44466,41034,40107,19,92,331,2277,4474,4474,194,44881,0,9.3,85.5,0.0,0.0,0.2,0.5,4.1,4359,40107,19,73,239,1946
E14000730,HARROGATE AND KNARESBOROUGH,51229,51165,96.7,77.9,75.5,2.3,2.3,0.0,0.2,0.4,3.2,0.3,98.0,49522,39907,38690,18,109,215,1643,1168,1169,150,50218,322,21.1,75.5,0.6,0.0,0.2,0.2,2.8,10832,38690,18,91,106,1428
E14000731,HARROW EAST,40043,39964,98.2,83.9,83.7,22.1,22.1,0.0,0.0,0.8,1.6,0.3,98.5,39327,33597,33532,0,1,325,637,8834,8834,109,39433,0,14.5,83.7,0.0,0.0,0.0,0.8,0.8,5795,33532,0,1,324,312
E14000732,HARROW WEST,45551,45340,97.1,81.2,81.0,9.8,9.8,0.0,0.0,0.1,2.4,0.5,97.2,44247,36993,36904,0,7,65,1093,4447,4447,210,44259,0,16.1,81.0,0.0,0.0,0.0,0.1,2.3,7343,36904,0,7,58,1028
E14000733,HARTLEPOOL,47166,46976,96.1,88.0,87.9,3.1,3.1,0.3,0.5,1.2,3.5,0.4,96.7,45328,41524,41472,140,250,544,1648,1443,1443,200,45610,0,8.2,87.9,0.0,0.3,0.2,0.6,2.3,3856,41472,140,110,294,1104
E14000734,HARWICH AND NORTH ESSEX,44680,44244,86.7,14.0,14.0,13.4,13.4,0.9,2.8,5.5,12.3,2.4,91.9,38742,6276,6238,395,1243,2440,5502,5985,5985,1059,41047,0,72.7,14.0,0.0,0.9,1.9,2.7,6.9,32504,6238,395,848,1197,3062
E14000735,HASTINGS AND RYE,57130,57038,97.3,3.5,3.5,3.5,3.5,0.1,0.1,0.2,2.5,0.2,99.7,55585,2012,2012,31,66,139,1453,2012,2012,95,56975,0,93.8,3.5,0.0,0.1,0.1,0.1,2.3,53573,2012,31,35,73,1314
E14000736,HAVANT,44231,44087,98.8,84.1,84.0,1.4,1.4,0.0,0.0,0.2,0.9,0.3,99.4,43679,37203,37169,0,2,78,408,626,626,144,43968,0,14.7,84.0,0.0,0.0,0.0,0.2,0.7,6510,37169,0,2,76,330
E14000737,HAYES AND HARLINGTON,45677,45356,95.7,85.7,85.7,7.4,7.4,0.1,0.2,1.0,3.6,0.7,95.8,43700,39162,39145,27,77,450,1656,3388,3388,320,43751,0,10.0,85.7,0.0,0.1,0.1,0.8,2.6,4555,39145,27,50,373,1206
E14000738,HAZEL GROVE,38184,38021,97.2,85.0,84.9,0.4,0.5,0.1,0.4,0.5,2.4,0.4,98.6,37101,32451,32423,24,156,209,920,154,173,167,37647,0,12.3,84.9,0.0,0.1,0.3,0.1,1.9,4678,32423,24,132,53,711
E14000739,HEMEL HEMPSTEAD,47276,47232,97.4,84.2,80.4,4.3,4.3,0.1,0.4,0.7,2.5,0.2,98.9,46040,39794,38020,52,198,352,1192,2055,2055,84,46762,0,17.0,80.4,0.0,0.1,0.3,0.3,1.8,8020,38020,52,146,154,840
E14000740,HEMSWORTH,45978,45595,93.6,19.7,19.0,14.3,14.3,0.0,0.4,0.8,5.5,0.9,98.1,43047,9049,8743,22,178,382,2548,6573,6573,423,45111,300,74.6,19.0,0.7,0.0,0.3,0.4,4.7,34304,8743,22,156,204,2166
E14000741,HENDON,57139,57081,97.0,55.1,54.5,15.5,15.5,0.0,0.0,0.1,2.9,0.1,98.1,55433,31489,31152,0,11,45,1648,8879,8879,58,56041,0,42.5,54.5,0.0,0.0,0.0,0.1,2.8,24281,31152,0,11,34,1603
E14000742,HENLEY,46974,46856,95.4,40.5,35.2,25.8,25.8,0.2,0.5,0.9,4.3,0.5,99.5,44823,19040,16535,95,228,430,2033,12112,12113,218,46731,0,60.2,35.2,0.0,0.2,0.3,0.4,3.4,28288,16535,95,133,202,1603
E14000743,HEREFORD AND SOUTH HEREFORDSHIRE,47631,47469,90.9,19.3,12.8,8.4,8.4,1.0,2.1,3.8,8.8,1.6,96.5,43275,9185,6120,482,988,1824,4194,3994,3994,778,45959,20,78.0,12.8,0.0,1.0,1.1,1.8,5.0,37155,6120,482,506,836,2370
E14000744,HERTFORD AND STORTFORD,51684,51657,97.4,82.9,79.0,8.2,8.2,0.1,0.2,0.3,2.6,0.2,98.8,50322,42848,40833,46,100,154,1335,4220,4220,90,51046,0,18.4,79.0,0.0,0.1,0.1,0.1,2.3,9489,40833,46,54,54,1181
E14000745,HERTSMERE,46324,46275,98.1,83.5,81.0,6.5,6.5,0.0,0.2,0.4,1.8,0.1,99.1,45461,38701,37533,5,92,168,814,3018,3018,56,45915,0,17.1,81.0,0.0,0.0,0.2,0.2,1.4,7928,37533,5,87,76,646
E14000746,HEXHAM,36139,35973,86.3,8.3,6.9,5.7,5.7,2.2,3.9,5.3,13.3,1.5,98.3,31178,3017,2504,792,1423,1912,4795,2052,2052,542,35535,3148,79.3,6.9,8.7,2.2,1.7,1.4,8.0,28674,2504,792,631,489,2883
E14000747,HEYWOOD AND MIDDLETON,51126,51072,97.2,69.4,63.0,4.2,4.2,0.0,0.1,0.2,2.6,0.1,99.1,49719,35477,32196,13,43,117,1353,2150,2158,60,50659,0,34.3,63.0,0.0,0.0,0.1,0.1,2.4,17523,32196,13,30,74,1236
E14000748,HIGH PEAK,46014,45873,91.9,11.3,8.0,4.1,4.1,0.5,1.1,1.7,7.8,0.7,98.7,42299,5194,3696,221,500,805,3574,1898,1898,339,45433,0,83.9,8.0,0.0,0.5,0.6,0.7,6.0,38603,3696,221,279,305,2769
E14000749,HITCHIN AND HARPENDEN,45524,45459,95.1,68.7,67.5,6.7,6.7,0.1,0.4,1.0,4.8,0.4,98.2,43282,31267,30718,61,173,448,2177,3054,3054,172,44683,0,27.6,67.5,0.0,0.1,0.2,0.6,3.8,12564,30718,61,112,275,1729
E14000750,HOLBORN AND ST PANCRAS,76348,75798,94.9,88.8,86.1,30.7,30.7,0.0,0.0,0.0,4.4,0.7,94.9,72429,67789,65707,0,0,5,3369,23401,23401,541,72433,0,8.8,86.1,0.0,0.0,0.0,0.0,4.4,6722,65707,0,0,5,3364
E14000751,HORNCHURCH AND UPMINSTER,48372,48060,96.5,82.2,80.9,3.0,3.0,0.1,0.3,0.5,2.8,0.7,97.9,46696,39782,39138,36,123,261,1364,1465,1465,345,47345,0,15.6,80.9,0.0,0.1,0.2,0.3,2.3,7558,39138,36,87,138,1103
E14000752,HORNSEY AND WOOD GREEN,55686,55641,97.8,79.6,77.8,1.6,1.6,0.0,0.0,0.3,2.1,0.1,98.0,54465,44335,43304,0,0,159,1176,873,873,45,54565,0,20.0,77.8,0.0,0.0,0.0,0.3,1.8,11161,43304,0,0,159,1017
E14000753,HORSHAM,52677,52349,93.6,37.8,29.1,21.0,21.0,0.1,0.7,1.5,5.7,1.0,98.7,49328,19908,15324,68,357,808,3021,11086,11086,516,52018,0,64.6,29.1,0.0,0.1,0.5,0.9,4.2,34004,15324,68,289,451,2213
E14000754,HOUGHTON AND SUNDERLAND SOUTH,43695,43480,95.3,57.3,52.5,16.2,16.2,0.1,0.2,0.8,4.2,0.6,97.7,41649,25034,22956,37,106,356,1831,7058,7058,274,42707,0,42.8,52.5,0.0,0.1,0.2,0.6,3.4,18693,22956,37,69,250,1475
E14000755,HOVE,52437,52379,98.5,87.2,81.3,1.3,1.3,0.0,0.0,0.2,1.3,0.1,98.6,51673,45706,42635,1,9,102,706,685,685,59,51692,0,17.2,81.3,0.0,0.0,0.0,0.2,1.2,9038,42635,1,8,93,604
E14000756,HUDDERSFIELD,45563,45544,99.1,91.8,91.7,37.8,37.8,0.0,0.0,0.2,0.8,0.0,99.6,45169,41830,41767,1,20,70,375,17206,17206,20,45364,0,7.5,91.7,0.0,0.0,0.0,0.1,0.7,3402,41767,1,19,50,305
E14000757,HUNTINGDON,56227,56129,97.4,71.3,67.5,5.9,5.9,0.2,0.4,0.9,2.4,0.3,99.1,54784,40068,37957,94,250,509,1345,3331,3331,142,55744,0,29.9,67.5,0.0,0.2,0.3,0.5,1.5,16827,37957,94,156,259,836
E14000758,HYNDBURN,47069,46810,97.4,68.5,62.0,6.5,6.5,0.1,0.1,0.2,2.0,0.5,99.3,45864,32236,29191,25,41,109,946,3037,3070,246,46743,20526,35.4,62.0,43.6,0.1,0.0,0.1,1.8,16673,29191,25,16,68,837
E14000759,ILFORD NORTH,41818,41742,98.3,86.7,86.3,38.9,38.9,0.0,0.2,0.4,1.5,0.2,98.9,41103,36271,36075,1,65,160,639,16287,16287,75,41344,0,12.0,86.3,0.0,0.0,0.2,0.2,1.1,5028,36075,1,64,95,479
E14000760,ILFORD SOUTH,48359,48199,95.8,79.1,78.8,28.2,28.2,0.0,0.0,0.3,3.8,0.3,96.4,46347,38241,38126,0,0,169,1852,13648,13648,151,46602,0,17.0,78.8,0.0,0.0,0.0,0.3,3.5,8221,38126,0,0,169,1683
E14000761,IPSWICH,54471,54361,98.4,86.1,82.8,2.4,2.4,0.0,0.1,0.3,1.4,0.2,98.6,53577,46906,45093,0,39,169,784,1286,1286,110,53689,0,15.6,82.8,0.0,0.0,0.1,0.2,1.1,8484,45093,0,39,130,615
E14000762,ISLE OF WIGHT,78465,78192,93.8,26.8,26.8,26.8,26.8,0.3,0.7,1.3,5.9,0.6,99.4,73564,21055,21055,221,578,1007,4628,21055,21055,451,78000,0,66.9,26.8,0.0,0.3,0.5,0.5,4.6,52509,21055,221,357,429,3621
E14000763,ISLINGTON NORTH,54928,54896,97.5,90.8,90.5,5.7,5.7,0.0,0.0,0.0,2.4,0.1,97.5,53569,49849,49704,0,0,6,1327,3153,3153,32,53571,0,7.0,90.5,0.0,0.0,0.0,0.0,2.4,3865,49704,0,0,6,1321
E14000764,ISLINGTON SOUTH AND FINSBURY,63227,63180,93.3,72.3,70.6,25.1,25.1,0.0,0.0,0.0,6.6,0.1,93.3,58982,45687,44649,0,0,6,4198,15869,15876,46,58984,0,22.7,70.6,0.0,0.0,0.0,0.0,6.6,14333,44649,0,0,6,4192
E14000765,JARROW,41179,41170,96.9,73.4,73.0,1.1,1.1,0.1,0.5,0.9,3.1,0.0,98.5,39894,30237,30057,41,222,389,1276,452,452,11,40552,0,23.9,73.0,0.0,0.1,0.4,0.4,2.2,9837,30057,41,181,167,887
E14000766,KEIGHLEY,42075,42037,94.7,77.2,73.6,1.7,70.7,0.3,0.7,1.3,5.2,0.2,98.1,39856,32478,30987,121,292,549,2181,709,29766,71,41285,22472,21.1,73.6,53.4,0.3,0.4,0.6,3.9,8869,30987,121,171,257,1632
E14000767,KENILWORTH AND SOUTHAM,41054,40951,93.8,51.5,45.3,11.4,41.3,0.5,1.2,1.7,5.9,0.5,98.1,38517,21135,18602,212,475,713,2434,4675,16952,193,40255,2,48.5,45.3,0.0,0.5,0.6,0.6,4.2,19915,18602,212,263,238,1721
E14000768,KENSINGTON,71829,71794,96.0,88.0,83.6,18.1,18.1,0.0,0.0,0.1,4.0,0.0,96.0,68942,63241,60065,0,0,51,2852,12977,12977,35,68942,0,12.4,83.6,0.0,0.0,0.0,0.1,3.9,8877,60065,0,0,51,2801
E14000769,KETTERING,48831,48416,97.4,77.8,72.6,12.0,12.0,0.0,0.4,0.7,1.7,1.1,98.0,47570,38011,35437,24,192,329,846,5845,5845,518,47860,34,24.8,72.6,0.1,0.0,0.3,0.3,1.1,12133,35437,24,168,137,517
E14000770,KINGSTON AND SURBITON,52969,52890,97.6,92.1,87.0,3.2,3.2,0.0,0.0,0.2,2.2,0.2,97.8,51722,48777,46096,0,2,82,1168,1684,1684,81,51815,0,10.6,87.0,0.0,0.0,0.0,0.2,2.1,5626,46096,0,2,80,1086
E14000771,KINGSTON UPON HULL EAST,43625,43155,98.9,97.4,97.4,97.4,97.4,0.0,0.0,0.0,0.0,0.0,98.9,43146,42507,42507,0,0,8,9,42507,42507,11,43146,5614,1.5,97.4,12.9,0.0,0.0,0.0,0.0,639,42507,0,0,8,1
E14000772,KINGSTON UPON HULL NORTH,44624,43717,98.0,97.8,97.8,97.8,97.8,0.0,0.0,0.0,0.0,0.3,98.0,43712,43622,43622,0,0,0,5,43622,43622,152,43712,9612,0.2,97.8,21.5,0.0,0.0,0.0,0.0,90,43622,0,0,0,5
E14000773,KINGSTON UPON HULL WEST AND HESSLE,47802,47137,98.6,97.6,97.6,97.6,97.6,0.0,0.0,0.0,0.0,0.1,98.6,47120,46631,46631,0,0,2,17,46631,46631,52,47120,13828,1.0,97.6,28.9,0.0,0.0,0.0,0.0,489,46631,0,0,2,15
E14000774,KINGSWOOD,40146,40107,99.1,87.8,86.7,7.4,7.5,0.0,0.0,0.1,0.8,0.1,99.7,39786,35243,34796,4,11,43,321,2970,3019,40,40018,0,12.4,86.7,0.0,0.0,0.0,0.1,0.7,4990,34796,4,7,32,278
E14000775,KNOWSLEY,52737,52649,98.7,79.5,78.9,10.4,79.0,0.0,0.1,0.2,1.1,0.2,99.4,52073,41938,41629,8,62,106,576,5505,41637,100,52446,0,19.8,78.9,0.0,0.0,0.1,0.1,0.9,10444,41629,8,54,44,470
E14000776,LANCASTER AND FLEETWOOD,41396,41336,96.7,51.8,46.9,34.8,34.8,0.2,0.4,0.9,3.2,0.2,99.4,40018,21454,19427,91,183,352,1318,14399,14399,96,41139,80,49.7,46.9,0.2,0.2,0.2,0.4,2.3,20591,19427,91,92,169,966
E14000777,LEEDS CENTRAL,75213,75148,92.3,88.1,85.0,44.8,83.2,0.0,0.2,0.5,7.6,0.1,92.3,69402,66280,63906,1,160,375,5746,33662,62581,67,69412,0,7.3,85.0,0.0,0.0,0.2,0.3,7.1,5496,63906,1,159,215,5371
E14000778,LEEDS EAST,45665,45647,98.6,93.8,92.7,30.1,92.7,0.0,0.2,0.6,1.4,0.1,98.7,45015,42832,42317,0,80,270,632,13739,42315,46,45094,0,5.9,92.7,0.0,0.0,0.2,0.4,0.8,2698,42317,0,80,190,362
E14000779,LEEDS NORTH EAST,42486,42473,98.8,94.0,93.2,70.9,93.2,0.0,0.0,0.3,1.2,0.0,99.1,41983,39954,39595,4,8,139,490,30105,39586,14,42103,23,5.6,93.2,0.1,0.0,0.0,0.3,0.8,2388,39595,4,4,131,351
E14000780,LEEDS NORTH WEST,38095,38069,97.0,76.1,71.8,26.9,68.8,0.0,0.4,0.7,3.0,0.1,98.1,36936,29008,27343,14,150,264,1133,10232,26225,26,37360,5624,25.2,71.8,14.8,0.0,0.4,0.3,2.3,9593,27343,14,136,114,869
E14000781,LEEDS WEST,47532,47467,98.9,93.3,92.3,42.3,90.9,0.1,0.2,0.4,0.9,0.1,99.2,47018,44338,43852,29,95,177,449,20085,43229,64,47161,0,6.7,92.3,0.0,0.1,0.1,0.2,0.6,3166,43852,29,66,82,272
E14000782,LEICESTER EAST,45359,45303,98.6,84.8,84.3,8.6,8.6,0.0,0.0,0.4,1.3,0.1,98.9,44707,38480,38246,0,10,188,596,3900,3900,57,44881,0,14.2,84.3,0.0,0.0,0.0,0.4,0.9,6461,38246,0,10,178,408
E14000783,LEICESTER SOUTH,52600,52543,99.0,92.7,89.0,8.1,8.1,0.0,0.0,0.1,0.9,0.1,99.1,52093,48771,46834,0,0,39,450,4261,4261,56,52132,0,10.0,89.0,0.0,0.0,0.0,0.1,0.8,5259,46834,0,0,39,411
E14000784,LEICESTER WEST,47118,47085,99.5,94.3,93.5,5.8,5.8,0.0,0.0,0.1,0.4,0.1,99.6,46883,44412,44068,2,22,62,202,2723,2723,34,46935,0,6.0,93.5,0.0,0.0,0.0,0.1,0.3,2815,44068,2,20,40,140
E14000785,LEIGH,50838,50823,98.5,81.8,81.7,7.0,17.0,0.0,0.1,0.3,1.4,0.1,99.7,50097,41575,41549,22,55,148,726,3564,8659,26,50669,87,16.8,81.7,0.2,0.0,0.1,0.2,1.1,8548,41549,22,33,93,578
E14000786,LEWES,43936,43879,95.6,12.9,12.8,12.9,12.9,0.1,0.4,0.8,4.3,0.3,99.6,41997,5651,5620,61,158,341,1882,5646,5646,138,43765,0,82.8,12.8,0.0,0.1,0.2,0.4,3.5,36377,5620,61,97,183,1541
E14000787,LEWISHAM EAST,48415,48251,98.8,77.7,72.9,3.3,3.3,0.0,0.0,0.1,0.9,0.3,99.3,47829,37620,35305,0,0,51,422,1619,1619,164,48085,0,25.9,72.9,0.0,0.0,0.0,0.1,0.8,12524,35305,0,0,51,371
E14000788,LEWISHAM WEST AND PENGE,52266,52226,95.8,74.7,74.1,16.4,16.4,0.0,0.0,0.4,4.1,0.1,96.1,50091,39054,38732,0,0,189,2135,8552,8552,38,50239,0,21.7,74.1,0.0,0.0,0.0,0.4,3.7,11359,38732,0,0,189,1946
E14000789,"LEWISHAM, DEPTFORD",60540,60260,93.1,55.8,53.0,16.0,16.0,0.0,0.0,0.1,6.4,0.5,93.1,56363,33792,32081,0,0,45,3897,9689,9689,275,56373,0,40.1,53.0,0.0,0.0,0.0,0.1,6.4,24282,32081,0,0,45,3852
E14000790,LEYTON AND WANSTEAD,42394,42356,97.3,87.6,86.4,9.7,9.7,0.0,0.0,0.2,2.6,0.1,97.3,41260,37146,36631,0,2,103,1096,4093,4093,37,41267,0,10.9,86.4,0.0,0.0,0.0,0.2,2.3,4629,36631,0,2,101,993
E14000791,LICHFIELD,45871,45803,96.2,67.0,62.4,4.6,59.3,0.2,0.6,1.2,3.7,0.3,99.3,44125,30734,28624,93,285,545,1678,2111,27186,159,45539,0,33.8,62.4,0.0,0.2,0.4,0.6,2.5,15501,28624,93,192,260,1133
E14000792,LINCOLN,54276,54201,98.2,81.3,80.5,0.7,0.7,0.0,0.1,0.5,1.6,0.1,98.6,53311,44134,43666,17,45,281,890,388,388,70,53511,12382,17.8,80.5,22.8,0.0,0.1,0.4,1.1,9645,43666,17,28,236,609
E14000793,"LIVERPOOL, RIVERSIDE",70080,69618,84.5,66.9,60.8,20.3,56.8,0.0,0.0,0.5,14.8,0.7,84.9,59216,46899,42592,0,0,323,10402,14196,39801,462,59506,0,23.7,60.8,0.0,0.0,0.0,0.5,14.4,16624,42592,0,0,323,10079
E14000794,"LIVERPOOL, WALTON",45376,45016,98.3,83.6,82.7,5.3,81.7,0.0,0.1,0.1,0.9,0.8,98.7,44592,37931,37546,0,30,35,424,2425,37090,360,44768,0,15.5,82.7,0.0,0.0,0.1,0.0,0.9,7046,37546,0,30,5,389
E14000795,"LIVERPOOL, WAVERTREE",42420,42360,99.3,94.2,93.0,68.7,91.9,0.0,0.0,0.1,0.6,0.1,99.5,42104,39940,39464,0,1,49,256,29153,38972,60,42197,0,6.2,93.0,0.0,0.0,0.0,0.1,0.5,2640,39464,0,1,48,207
E14000796,"LIVERPOOL, WEST DERBY",42193,42115,99.5,89.6,89.2,44.1,88.9,0.0,0.0,0.0,0.3,0.2,99.7,41973,37789,37642,0,1,8,142,18604,37530,78,42074,0,10.3,89.2,0.0,0.0,0.0,0.0,0.3,4331,37642,0,1,7,134
E14000797,LOUGHBOROUGH,46398,46143,98.2,75.4,70.6,4.1,4.1,0.1,0.3,0.5,1.3,0.6,98.9,45554,34990,32737,67,120,209,589,1893,1893,268,45897,0,27.6,70.6,0.0,0.1,0.1,0.2,0.8,12817,32737,67,53,89,380
E14000798,LOUTH AND HORNCASTLE,50904,50776,88.5,16.9,16.6,4.2,4.2,0.8,2.2,4.1,11.2,1.2,97.9,45054,8603,8454,411,1131,2068,5722,2128,2128,608,49816,5506,71.9,16.6,10.8,0.8,1.4,1.8,7.2,36600,8454,411,720,937,3654
E14000799,LUDLOW,42112,41851,80.0,5.3,5.3,5.3,5.3,1.8,5.6,10.2,19.4,1.8,93.0,33691,2230,2229,758,2353,4316,8160,2229,2229,778,39152,30973,74.7,5.3,73.5,1.8,3.8,4.7,9.1,31462,2229,758,1595,1963,3844
E14000800,LUTON NORTH,38962,38936,99.8,96.1,94.7,1.1,1.1,0.0,0.0,0.1,0.1,0.1,99.9,38880,37460,36914,6,18,20,56,426,426,22,38911,0,5.0,94.7,0.0,0.0,0.0,0.0,0.1,1966,36914,6,12,2,36
E14000801,LUTON SOUTH,50082,50013,98.8,91.6,90.1,10.8,10.8,0.0,0.5,0.6,1.1,0.2,99.0,49469,45882,45107,13,239,287,544,5421,5421,96,49574,0,8.7,90.1,0.0,0.0,0.5,0.1,0.5,4362,45107,13,226,48,257
E14000802,MACCLESFIELD,46869,46804,94.1,67.7,67.6,3.5,3.5,0.2,1.0,1.9,5.8,0.5,98.2,44090,31708,31701,115,463,912,2714,1663,1663,244,46043,0,26.4,67.6,0.0,0.2,0.7,1.0,3.8,12389,31701,115,348,449,1802
E14000803,MAIDENHEAD,46689,46573,93.8,70.6,66.5,7.8,21.6,0.3,0.6,1.5,5.9,0.5,97.7,43797,32947,31035,136,295,684,2776,3647,10065,223,45635,0,27.3,66.5,0.0,0.3,0.3,0.8,4.5,12762,31035,136,159,389,2092
E14000804,MAIDSTONE AND THE WEALD,50698,50572,92.1,59.2,51.6,7.9,7.9,0.1,1.3,2.5,7.6,0.7,97.2,46696,30013,26177,64,659,1244,3876,4010,4010,364,49259,0,40.5,51.6,0.0,0.1,1.2,1.2,5.2,20519,26177,64,595,585,2632
E14000805,MAKERFIELD,45114,45084,97.9,83.5,82.1,2.5,2.5,0.0,0.0,0.1,2.0,0.1,99.5,44175,37671,37031,3,19,51,909,1106,1108,35,44905,16,15.8,82.1,0.0,0.0,0.0,0.1,1.9,7144,37031,3,16,32,858
E14000806,MALDON,42425,42340,92.9,21.5,19.2,15.3,15.3,0.2,0.6,1.2,6.9,0.5,99.3,39409,9125,8162,80,241,488,2931,6483,6483,191,42125,0,73.7,19.2,0.0,0.2,0.4,0.6,5.8,31247,8162,80,161,247,2443
E14000807,MANCHESTER CENTRAL,80961,80914,88.8,60.6,58.2,36.6,53.4,0.0,0.0,0.9,11.1,0.1,89.3,71908,49094,47108,0,18,718,9006,29661,43230,47,72260,0,30.6,58.2,0.0,0.0,0.0,0.9,10.2,24800,47108,0,18,700,8288
E14000808,"MANCHESTER, GORTON",48761,48724,98.4,70.5,64.6,16.8,34.1,0.0,0.1,0.3,1.5,0.1,98.5,47997,34392,31489,1,47,126,727,8181,16617,37,48040,0,33.9,64.6,0.0,0.0,0.1,0.2,1.2,16508,31489,1,46,79,601
E14000809,"MANCHESTER, WITHINGTON",44626,44578,98.4,89.6,86.2,2.4,82.1,0.0,0.0,0.2,1.5,0.1,98.5,43901,39990,38481,0,0,98,677,1073,36619,48,43937,0,12.1,86.2,0.0,0.0,0.0,0.2,1.3,5420,38481,0,0,98,579
E14000810,MANSFIELD,52763,52727,98.9,88.5,85.9,9.0,9.0,0.0,0.1,0.2,1.1,0.1,99.6,52172,46715,45319,5,34,83,555,4754,4754,36,52556,0,13.0,85.9,0.0,0.0,0.1,0.1,0.9,6853,45319,5,29,49,472
E14000811,MEON VALLEY,44262,44145,93.3,61.1,58.8,8.0,8.0,0.4,1.1,2.0,6.4,0.9,98.4,41293,27032,26030,169,484,883,2852,3555,3557,378,43560,0,34.5,58.8,0.0,0.4,0.7,0.9,4.4,15263,26030,169,315,399,1969
E14000812,MERIDEN,51682,51608,96.8,79.8,79.0,10.7,78.5,0.0,0.3,1.1,3.0,0.2,98.4,50050,41230,40845,18,146,592,1558,5532,40563,83,50837,0,17.8,79.0,0.0,0.0,0.2,0.9,1.9,9205,40845,18,128,446,966
E14000813,MID BEDFORDSHIRE,51377,51325,95.6,63.3,58.3,20.4,20.4,0.1,0.4,1.1,4.3,0.3,99.0,49112,32521,29954,68,223,552,2213,10456,10456,157,50864,0,37.3,58.3,0.0,0.1,0.3,0.6,3.2,19158,29954,68,155,329,1661
E14000814,MID DERBYSHIRE,39649,39603,97.3,60.9,54.8,11.0,11.0,0.2,0.4,0.5,2.6,0.1,99.5,38575,24159,21732,60,156,198,1028,4380,4380,54,39453,0,42.5,54.8,0.0,0.2,0.2,0.1,2.1,16843,21732,60,96,42,830
E14000815,MID DORSET AND NORTH POOLE,38269,38053,93.6,47.3,47.0,9.2,9.2,0.1,0.4,0.8,5.8,0.8,97.4,35815,18112,17985,50,156,288,2238,3521,3521,301,37255,4,46.6,47.0,0.0,0.1,0.3,0.3,5.1,17830,17985,50,106,132,1950
E14000816,MID NORFOLK,51493,51376,90.0,12.4,12.4,12.4,12.4,0.5,1.6,2.6,9.7,1.3,97.6,46367,6369,6367,266,803,1362,5009,6365,6365,678,50270,0,77.7,12.4,0.0,0.5,1.0,1.1,7.1,40000,6367,266,537,559,3647
E14000817,MID SUSSEX,52674,52472,95.8,36.1,31.8,28.3,28.3,0.1,0.2,0.6,3.8,0.6,99.1,50445,19023,16746,27,119,324,2027,14898,14898,303,52181,0,64.0,31.8,0.0,0.1,0.2,0.4,3.2,33699,16746,27,92,205,1703
E14000818,MID WORCESTERSHIRE,50444,50231,94.8,22.5,17.5,8.5,8.7,0.1,0.5,1.2,4.8,0.7,98.9,47816,11342,8834,47,270,582,2415,4298,4376,346,49882,164,77.3,17.5,0.3,0.1,0.4,0.6,3.6,38982,8834,47,223,312,1833
E14000819,MIDDLESBROUGH,46545,46530,96.7,89.4,88.9,1.5,1.5,0.1,0.5,1.1,3.2,0.0,96.9,45028,41627,41368,61,245,522,1502,691,691,15,45079,139,7.9,88.9,0.3,0.1,0.4,0.6,2.1,3660,41368,61,184,277,980
E14000820,MIDDLESBROUGH SOUTH AND EAST CLEVELAND,45720,45711,95.4,83.5,83.4,2.8,2.8,0.2,0.7,1.5,4.6,0.2,97.4,43599,38173,38123,73,309,693,2112,1298,1298,73,44550,32,12.0,83.4,0.1,0.2,0.5,0.8,3.1,5476,38123,73,236,384,1419
E14000821,MILTON KEYNES NORTH,60186,60097,97.2,81.7,80.1,78.2,78.2,0.0,0.4,1.5,2.6,0.3,98.2,58526,49194,48197,27,259,883,1571,47057,47057,175,59078,0,17.2,80.1,0.0,0.0,0.4,1.0,1.1,10329,48197,27,232,624,688
E14000822,MILTON KEYNES SOUTH,61263,61146,98.6,90.8,89.3,88.3,88.3,0.1,0.4,0.6,1.2,0.2,99.1,60389,55618,54725,59,229,344,757,54116,54116,123,60719,0,9.2,89.3,0.0,0.1,0.3,0.2,0.7,5664,54725,59,170,115,413
E14000823,MITCHAM AND MORDEN,44226,44209,98.3,88.1,87.6,12.1,12.1,0.0,0.1,0.1,1.6,0.0,98.4,43494,38952,38739,0,25,52,715,5358,5358,17,43502,0,10.8,87.6,0.0,0.0,0.1,0.1,1.5,4755,38739,0,25,27,663
E14000824,MOLE VALLEY,43501,43441,93.9,48.5,47.0,10.4,10.4,0.1,0.4,1.0,6.0,0.5,99.3,40830,21110,20432,37,170,452,2611,4515,4515,235,43184,0,46.9,47.0,0.0,0.1,0.3,0.6,5.0,20398,20432,37,133,282,2159
E14000825,MORECAMBE AND LUNESDALE,44965,44919,98.8,66.6,56.1,10.3,10.3,0.1,0.2,0.3,1.1,0.1,99.7,44406,29934,25207,65,92,129,513,4625,4625,63,44829,302,42.7,56.1,0.7,0.1,0.1,0.1,0.9,19199,25207,65,27,37,384
E14000826,MORLEY AND OUTWOOD,48440,48412,97.4,80.9,78.7,59.3,65.2,0.1,0.4,0.6,2.5,0.1,99.3,47179,39199,38128,37,196,313,1233,28712,31582,35,48097,0,18.7,78.7,0.0,0.1,0.3,0.2,1.9,9051,38128,37,159,117,920
E14000827,NEW FOREST EAST,42371,42277,92.3,36.1,23.3,2.7,2.8,0.6,0.9,1.8,7.5,1.0,98.6,39092,15284,9885,255,398,762,3185,1142,1171,433,41777,0,68.9,23.3,0.0,0.6,0.3,0.9,5.7,29207,9885,255,143,364,2423
E14000828,NEW FOREST WEST,44879,44764,93.6,17.5,17.3,17.4,17.4,0.4,0.8,1.3,6.1,0.8,99.1,42029,7843,7785,175,338,582,2735,7790,7790,355,44478,0,76.3,17.3,0.0,0.4,0.4,0.5,4.8,34244,7785,175,163,244,2153
E14000829,NEWARK,50003,49798,95.4,51.6,50.9,9.0,9.0,0.4,1.1,1.7,4.2,0.7,98.6,47679,25806,25429,188,545,831,2119,4520,4520,346,49313,241,44.5,50.9,0.5,0.4,0.7,0.6,2.6,22250,25429,188,357,286,1288
E14000830,NEWBURY,51193,51125,97.4,74.9,70.3,31.7,66.3,0.0,0.3,0.6,2.4,0.2,98.6,49875,38323,35991,19,160,325,1250,16237,33965,119,50498,0,27.1,70.3,0.0,0.0,0.3,0.3,1.8,13884,35991,19,141,165,925
E14000831,NEWCASTLE UPON TYNE CENTRAL,51499,51318,92.6,77.7,71.7,27.5,27.5,0.0,0.0,0.1,7.1,0.4,92.7,47685,40035,36929,0,1,65,3633,14162,14179,181,47753,0,20.9,71.7,0.0,0.0,0.0,0.1,6.9,10756,36929,0,1,64,3568
E14000832,NEWCASTLE UPON TYNE EAST,48768,48671,96.6,71.0,65.2,3.7,3.7,0.0,0.0,0.1,3.2,0.2,96.8,47089,34617,31803,4,9,59,1582,1800,1800,97,47196,0,31.3,65.2,0.0,0.0,0.0,0.1,3.1,15286,31803,4,5,50,1523
E14000833,NEWCASTLE UPON TYNE NORTH,45781,45663,97.3,61.9,57.5,25.4,25.4,0.0,0.2,0.3,2.4,0.3,99.4,44560,28335,26315,12,69,135,1103,11637,11637,118,45496,0,39.9,57.5,0.0,0.0,0.1,0.1,2.1,18245,26315,12,57,66,968
E14000834,NEWCASTLE-UNDER-LYME,44309,43839,96.7,73.5,72.2,6.4,6.4,0.0,0.1,0.3,2.2,1.1,98.3,42846,32574,31977,4,26,141,993,2852,2852,481,43576,148,24.5,72.2,0.3,0.0,0.0,0.3,1.9,10869,31977,4,22,115,852
E14000835,NEWTON ABBOT,45898,45807,92.5,41.4,41.3,6.0,6.0,0.3,1.2,2.1,7.3,0.5,98.0,42454,19015,18969,142,553,983,3353,2759,2759,240,44961,7241,51.2,41.3,15.8,0.3,0.9,0.9,5.2,23485,18969,142,411,430,2370
E14000836,"NORMANTON, PONTEFRACT AND CASTLEFORD",54067,53660,96.6,64.9,64.3,24.3,24.3,0.1,0.4,0.7,2.6,0.8,97.4,52251,35071,34779,34,230,370,1409,13160,13160,417,52674,290,32.3,64.3,0.5,0.1,0.4,0.3,1.9,17472,34779,34,196,140,1039
E14000837,NORTH CORNWALL,51058,50748,87.7,37.4,37.4,37.4,37.4,0.6,1.5,3.3,11.7,1.4,93.6,44793,19106,19105,291,790,1705,5955,19105,19105,709,47786,1115,50.3,37.4,2.2,0.6,1.0,1.8,8.3,25688,19105,291,499,915,4250
E14000838,NORTH DEVON,51268,51052,86.3,4.7,4.7,4.7,4.7,1.5,3.5,6.7,13.2,1.7,93.9,44261,2395,2395,772,1788,3418,6791,2395,2395,889,48126,27370,81.7,4.7,53.4,1.5,2.0,3.2,6.6,41866,2395,772,1016,1630,3373
E14000839,NORTH DORSET,45443,45342,89.6,11.0,10.9,10.7,10.7,0.4,1.5,2.8,10.2,0.7,98.6,40702,5000,4940,189,698,1295,4640,4859,4859,337,44808,12826,78.7,10.9,28.2,0.4,1.1,1.3,7.4,35762,4940,189,509,597,3345
E14000840,NORTH DURHAM,44127,44062,93.6,24.0,18.9,7.4,7.4,0.0,0.2,1.1,6.3,0.3,98.4,41291,10593,8353,9,89,495,2771,3273,3273,152,43440,0,74.6,18.9,0.0,0.0,0.2,0.9,5.2,32938,8353,9,80,406,2276
E14000841,NORTH EAST BEDFORDSHIRE,53288,53231,94.9,51.8,48.7,8.5,8.5,0.3,1.3,1.9,5.0,0.3,98.6,50547,27612,25967,143,690,1020,2684,4546,4546,147,52533,0,46.1,48.7,0.0,0.3,1.0,0.6,3.1,24580,25967,143,547,330,1664
E14000842,NORTH EAST CAMBRIDGESHIRE,55962,55829,94.0,53.2,51.3,25.6,25.6,0.4,1.1,1.8,5.8,0.5,98.5,52605,29794,28707,231,615,985,3224,14324,14324,303,55124,6382,42.7,51.3,11.4,0.4,0.7,0.7,4.0,23898,28707,231,384,370,2239
E14000843,NORTH EAST DERBYSHIRE,44394,44329,94.3,31.7,29.9,26.8,26.8,0.3,0.8,1.3,5.6,0.3,99.6,41855,14052,13290,151,344,563,2474,11915,11915,116,44223,0,64.3,29.9,0.0,0.3,0.4,0.5,4.3,28565,13290,151,193,219,1911
E14000844,NORTH EAST HAMPSHIRE,47115,46778,93.8,53.1,53.0,11.4,11.4,0.1,0.8,1.4,5.5,1.0,98.4,44195,25019,24962,59,363,673,2583,5384,5385,468,46378,0,40.8,53.0,0.0,0.1,0.6,0.7,4.1,19233,24962,59,304,310,1910
E14000845,NORTH EAST HERTFORDSHIRE,46095,46027,94.8,56.6,55.0,5.1,5.1,0.1,0.7,1.6,5.1,0.5,97.7,43693,26069,25345,68,321,731,2334,2341,2341,229,45045,0,39.8,55.0,0.0,0.1,0.5,0.9,3.5,18348,25345,68,253,410,1603
E14000846,NORTH EAST SOMERSET,43182,43067,85.9,47.0,42.4,17.1,17.1,0.6,1.5,3.4,13.9,1.0,93.0,37086,20278,18301,275,644,1477,5981,7387,7387,449,40158,0,43.5,42.4,0.0,0.6,0.9,1.9,10.4,18785,18301,275,369,833,4504
E14000847,NORTH HEREFORDSHIRE,42651,42505,83.0,30.8,28.5,26.9,26.9,1.1,4.0,7.3,16.7,2.6,93.7,35399,13126,12162,489,1700,3112,7106,11471,11471,1090,39943,3318,54.5,28.5,7.8,1.1,2.8,3.3,9.4,23237,12162,489,1211,1412,3994
E14000848,NORTH NORFOLK,50892,50742,90.7,4.5,4.5,4.5,4.5,0.5,1.4,2.5,9.0,1.8,97.6,46152,2285,2285,259,732,1296,4590,2279,2279,918,49690,0,86.2,4.5,0.0,0.5,0.9,1.1,6.5,43867,2285,259,473,564,3294
E14000849,NORTH SHROPSHIRE,51040,50924,87.8,15.1,9.6,5.5,5.5,0.8,2.3,4.5,12.0,0.5,98.0,44800,7732,4890,391,1183,2288,6124,2808,2808,276,50033,38762,78.2,9.6,75.9,0.8,1.6,2.2,7.5,39910,4890,391,792,1105,3836
E14000850,NORTH SOMERSET,48436,48215,91.3,52.0,47.0,6.1,6.1,0.5,1.4,2.6,8.3,0.7,95.6,44199,25178,22750,257,656,1247,4016,2947,2947,346,46326,0,44.3,47.0,0.0,0.5,0.8,1.2,5.7,21449,22750,257,399,591,2769
E14000851,NORTH SWINDON,52793,52779,94.2,78.8,76.3,17.5,17.5,0.0,1.0,2.0,5.7,0.8,94.7,49755,41582,40283,17,529,1057,3024,9247,9247,418,50003,0,17.9,76.3,0.0,0.0,1.0,1.0,3.7,9472,40283,17,512,528,1967
E14000852,NORTH THANET,49485,49348,94.6,30.5,30.4,30.5,30.5,0.0,0.2,2.1,5.2,0.4,99.1,46797,15096,15024,16,86,1053,2551,15089,15089,196,49047,0,64.2,30.4,0.0,0.0,0.1,2.0,3.0,31773,15024,16,70,967,1498
E14000853,NORTH TYNESIDE,53610,53484,97.8,49.8,46.3,1.5,1.5,0.0,0.0,0.5,2.0,0.2,99.1,52411,26722,24804,1,20,255,1073,823,823,128,53154,0,51.5,46.3,0.0,0.0,0.0,0.4,1.5,27607,24804,1,19,235,818
E14000854,NORTH WARWICKSHIRE,42996,42934,97.2,50.0,48.6,10.8,47.6,0.1,0.6,0.9,2.7,0.2,99.4,41778,21481,20907,64,238,390,1156,4655,20462,88,42740,0,48.5,48.6,0.0,0.1,0.4,0.4,1.8,20871,20907,64,174,152,766
E14000855,NORTH WEST CAMBRIDGESHIRE,63422,63057,95.4,53.6,49.9,23.0,23.0,0.2,0.6,0.9,4.0,0.7,98.3,60533,33998,31672,152,403,577,2524,14562,14562,447,62336,316,45.5,49.9,0.5,0.2,0.4,0.3,3.1,28861,31672,152,251,174,1947
E14000856,NORTH WEST DURHAM,47351,47238,93.7,32.6,29.4,28.6,28.6,0.6,1.0,1.6,6.0,0.6,99.3,44386,15414,13939,261,495,770,2852,13544,13544,303,47005,0,64.3,29.4,0.0,0.6,0.5,0.6,4.4,30447,13939,261,234,275,2082
E14000857,NORTH WEST HAMPSHIRE,50606,50526,93.0,52.6,50.0,18.1,18.4,0.3,0.9,2.1,6.8,0.9,97.7,47076,26632,25313,128,476,1067,3450,9148,9292,431,49420,0,43.0,50.0,0.0,0.3,0.7,1.2,4.7,21763,25313,128,348,591,2383
E14000858,NORTH WEST LEICESTERSHIRE,48334,48257,95.7,67.5,65.8,4.3,4.3,0.2,0.8,1.4,4.1,0.5,99.0,46271,32604,31803,73,403,687,1986,2075,2075,220,47833,0,29.9,65.8,0.0,0.2,0.7,0.6,2.7,14468,31803,73,330,284,1299
E14000859,NORTH WEST NORFOLK,52977,52699,92.2,13.5,7.1,3.2,3.2,0.2,0.8,1.7,7.2,1.1,98.0,48864,7159,3762,113,404,910,3835,1706,1706,564,51918,0,85.1,7.1,0.0,0.2,0.5,1.0,5.5,45102,3762,113,291,506,2925
E14000860,NORTH WILTSHIRE,43747,43627,91.0,28.4,26.7,14.7,14.7,0.5,1.8,3.5,8.7,1.0,98.5,39825,12432,11690,231,783,1552,3802,6448,6448,458,43080,1,64.3,26.7,0.0,0.5,1.3,1.8,5.1,28135,11690,231,552,769,2250
E14000861,NORTHAMPTON NORTH,40811,40204,97.7,90.7,90.2,2.5,2.5,0.0,0.0,0.1,0.8,1.5,97.7,39859,37013,36824,0,5,45,345,1012,1012,609,39880,302,7.4,90.2,0.7,0.0,0.0,0.1,0.7,3035,36824,0,5,40,300
E14000862,NORTHAMPTON SOUTH,48943,47674,96.8,80.5,78.1,6.4,6.4,0.0,0.0,0.1,0.6,2.6,97.0,47385,39397,38230,0,5,49,289,3113,3114,1269,47481,924,18.7,78.1,1.9,0.0,0.0,0.1,0.5,9155,38230,0,5,44,240
E14000863,NORWICH NORTH,40627,40575,99.2,86.6,84.7,1.7,1.7,0.0,0.0,0.1,0.7,0.1,99.6,40297,35191,34411,1,8,27,278,686,686,52,40481,0,14.5,84.7,0.0,0.0,0.0,0.0,0.6,5886,34411,1,7,19,251
E14000864,NORWICH SOUTH,43119,43040,98.2,83.2,80.0,0.3,0.3,0.0,0.0,0.6,1.6,0.2,98.5,42339,35864,34516,0,3,241,701,131,131,79,42487,0,18.1,80.0,0.0,0.0,0.0,0.6,1.1,7823,34516,0,3,238,460
E14000865,NOTTINGHAM EAST,49892,49860,97.6,92.0,89.8,30.4,30.4,0.0,0.0,0.0,2.3,0.1,97.8,48718,45909,44801,0,0,2,1142,15162,15162,28,48776,0,7.9,89.8,0.0,0.0,0.0,0.0,2.3,3917,44801,0,0,2,1140
E14000866,NOTTINGHAM NORTH,45273,45263,99.5,95.3,94.9,12.0,12.0,0.0,0.1,0.1,0.5,0.0,99.8,45049,43132,42976,2,37,49,214,5428,5428,11,45185,0,4.6,94.9,0.0,0.0,0.1,0.0,0.4,2073,42976,2,35,12,165
E14000867,NOTTINGHAM SOUTH,50653,50613,96.9,88.6,86.3,19.9,19.9,0.0,0.1,0.6,3.1,0.1,96.9,49059,44855,43730,2,31,298,1554,10103,10103,41,49091,0,10.5,86.3,0.0,0.0,0.1,0.5,2.5,5329,43730,2,29,267,1256
E14000868,NUNEATON,44629,44596,98.8,70.5,70.4,5.5,70.4,0.1,0.3,0.4,1.1,0.1,99.6,44114,31446,31432,45,137,176,482,2443,31432,39,44443,0,28.4,70.4,0.0,0.1,0.2,0.1,0.7,12682,31432,45,92,39,306
E14000869,OLD BEXLEY AND SIDCUP,38306,38252,97.4,66.2,63.4,11.3,11.3,0.0,0.0,0.2,2.5,0.2,98.8,37313,25354,24279,5,12,78,939,4328,4328,59,37843,0,34.0,63.4,0.0,0.0,0.0,0.2,2.2,13034,24279,5,7,66,861
E14000870,OLDHAM EAST AND SADDLEWORTH,45183,45094,96.7,66.0,65.3,3.1,3.1,0.2,0.4,0.5,3.1,0.2,99.4,43703,29804,29512,74,159,240,1391,1411,1411,88,44933,0,31.4,65.3,0.0,0.2,0.2,0.2,2.5,14191,29512,74,85,81,1151
E14000871,OLDHAM WEST AND ROYTON,43319,43233,99.3,83.8,83.8,8.5,8.7,0.0,0.0,0.2,0.5,0.2,99.6,43010,36312,36300,0,0,87,223,3684,3775,85,43133,0,15.5,83.8,0.0,0.0,0.0,0.2,0.3,6710,36300,0,0,87,136
E14000872,ORPINGTON,40180,40159,95.5,84.4,84.3,4.2,4.2,0.1,0.9,1.5,4.4,0.2,97.5,38373,33927,33888,53,354,606,1786,1687,1694,66,39191,0,11.2,84.3,0.0,0.1,0.7,0.6,2.9,4485,33888,53,301,252,1180
E14000873,OXFORD EAST,52356,52273,97.3,85.6,81.8,3.2,3.2,0.0,0.1,0.4,2.5,0.2,97.5,50945,44804,42850,0,30,189,1328,1660,1660,84,51024,0,15.5,81.8,0.0,0.0,0.1,0.3,2.2,8095,42850,0,30,159,1139
E14000874,OXFORD WEST AND ABINGDON,49398,49290,98.1,84.0,79.2,5.7,5.7,0.0,0.1,0.1,1.7,0.2,98.8,48441,41516,39113,17,31,70,849,2827,2828,118,48790,0,18.9,79.2,0.0,0.0,0.0,0.1,1.6,9328,39113,17,14,39,779
E14000875,PENDLE,43756,43606,96.1,52.7,52.3,1.4,51.9,0.4,0.9,1.3,3.6,0.5,98.7,42032,23038,22881,169,393,553,1574,625,22691,216,43209,1815,43.8,52.3,4.1,0.4,0.5,0.4,2.3,19151,22881,169,224,160,1021
E14000876,PENISTONE AND STOCKSBRIDGE,42410,42359,94.2,12.2,11.4,5.0,5.0,0.2,0.5,1.2,5.7,0.2,98.1,39939,5177,4841,90,219,527,2420,2132,2132,86,41618,0,82.8,11.4,0.0,0.2,0.3,0.7,4.5,35098,4841,90,129,308,1893
E14000877,PENRITH AND THE BORDER,45280,45011,81.5,9.3,7.9,5.9,5.9,3.9,7.5,10.5,17.9,3.2,94.8,36902,4221,3574,1751,3379,4772,8109,2684,2684,1442,42929,1453,73.6,7.9,3.2,3.9,3.6,3.1,7.4,33328,3574,1751,1628,1393,3337
E14000878,PETERBOROUGH,55152,55072,98.2,85.1,85.0,54.7,54.7,0.1,0.3,0.5,1.7,0.2,99.0,54144,46926,46859,51,150,267,928,30148,30148,110,54625,0,13.2,85.0,0.0,0.1,0.2,0.2,1.2,7285,46859,51,99,117,661
E14000879,"PLYMOUTH, MOOR VIEW",43971,43626,97.6,87.2,87.1,3.6,3.6,0.0,0.2,0.6,1.6,0.8,98.3,42902,38355,38310,3,68,272,724,1604,1604,352,43242,19169,10.4,87.1,43.6,0.0,0.1,0.5,1.0,4592,38310,3,65,204,452
E14000880,"PLYMOUTH, SUTTON AND DEVONPORT",56075,56000,95.3,87.4,83.7,1.5,1.5,0.0,0.1,1.0,4.6,0.1,95.4,53416,49029,46923,0,38,586,2584,827,827,75,53484,10629,11.6,83.7,19.0,0.0,0.1,1.0,3.6,6493,46923,0,38,548,1998
E14000881,POOLE,51906,51789,98.0,74.1,72.1,0.8,0.8,0.0,0.0,0.1,1.7,0.2,98.8,50882,38458,37437,0,1,40,907,400,400,117,51280,0,25.9,72.1,0.0,0.0,0.0,0.1,1.7,13445,37437,0,1,39,867
E14000882,POPLAR AND LIMEHOUSE,77532,77398,94.0,72.0,70.8,59.3,59.3,0.0,0.0,0.6,5.8,0.2,94.1,72917,55853,54880,0,32,459,4481,45967,45967,134,72936,0,23.3,70.8,0.0,0.0,0.0,0.6,5.2,18037,54880,0,32,427,4022
E14000883,PORTSMOUTH NORTH,44192,44158,98.1,94.4,93.3,6.1,6.1,0.0,0.2,0.7,1.8,0.1,98.2,43359,41731,41253,1,104,322,799,2703,2703,35,43389,0,4.8,93.3,0.0,0.0,0.2,0.5,1.1,2106,41253,1,103,218,477
E14000884,PORTSMOUTH SOUTH,51475,51344,97.2,93.2,90.5,7.9,7.9,0.0,0.0,0.2,2.6,0.3,97.3,50008,47992,46587,0,4,86,1336,4042,4042,131,50068,0,6.6,90.5,0.0,0.0,0.0,0.2,2.4,3421,46587,0,4,82,1250
E14000885,PRESTON,45542,45407,98.0,73.1,71.0,1.4,1.4,0.0,0.0,0.2,1.7,0.5,98.7,44619,33310,32322,0,3,112,788,631,631,213,44933,18417,27.0,71.0,40.4,0.0,0.0,0.2,1.5,12297,32322,0,3,109,676
E14000886,PUDSEY,44591,44553,98.6,80.4,77.8,26.5,75.3,0.0,0.0,0.1,1.3,0.1,99.5,43957,35865,34672,4,15,40,596,11800,33564,38,44357,1289,20.8,77.8,2.9,0.0,0.0,0.1,1.2,9285,34672,4,11,25,556
E14000887,PUTNEY,46215,45957,96.8,83.4,72.5,37.0,37.0,0.0,0.0,0.1,2.6,0.5,96.9,44755,38521,33499,0,14,58,1202,17098,17098,251,44768,0,24.4,72.5,0.0,0.0,0.0,0.1,2.5,11256,33499,0,14,44,1144
E14000888,RAYLEIGH AND WICKFORD,44133,44040,97.8,33.9,31.8,11.5,11.5,0.0,0.1,0.3,2.0,0.2,99.4,43168,14964,14025,1,29,124,872,5064,5064,104,43887,0,66.0,31.8,0.0,0.0,0.1,0.2,1.7,29143,14025,1,28,95,748
E14000889,READING EAST,51517,51394,98.3,87.6,84.6,8.6,81.8,0.0,0.0,0.0,1.5,0.2,98.4,50624,45149,43574,0,6,20,770,4421,42136,123,50718,0,13.7,84.6,0.0,0.0,0.0,0.0,1.5,7050,43574,0,6,14,750
E14000890,READING WEST,48265,48214,98.9,88.5,84.8,9.1,81.9,0.0,0.1,0.1,1.0,0.1,99.3,47752,42692,40934,3,28,65,462,4380,39520,51,47917,0,14.1,84.8,0.0,0.0,0.1,0.1,0.8,6818,40934,3,25,37,397
E14000891,REDCAR,43385,43353,98.2,92.4,90.8,0.5,0.5,0.0,0.3,0.8,1.7,0.2,98.4,42608,40072,39385,21,145,361,745,229,229,81,42705,236,7.4,90.8,0.5,0.0,0.3,0.5,0.9,3223,39385,21,124,216,384
E14000892,REDDITCH,42125,42027,96.9,73.8,73.8,2.5,73.8,0.0,0.3,0.4,2.9,0.3,99.0,40826,31097,31071,19,106,183,1201,1046,31077,131,41683,90,23.2,73.8,0.2,0.0,0.2,0.2,2.4,9755,31071,19,87,77,1018
E14000893,REIGATE,46022,45985,97.1,71.5,70.5,13.5,13.5,0.0,0.2,0.3,2.8,0.2,99.6,44679,32919,32468,11,75,142,1306,6216,6216,72,45847,0,26.5,70.5,0.0,0.0,0.1,0.1,2.5,12211,32468,11,64,67,1164
E14000894,RIBBLE VALLEY,49782,49689,93.4,41.1,40.8,15.6,15.8,0.5,1.3,2.4,6.4,0.5,98.9,46492,20478,20296,228,660,1207,3197,7754,7852,273,49251,15680,52.6,40.8,31.5,0.5,0.9,1.1,4.0,26196,20296,228,432,547,1990
E14000895,RICHMOND (YORKS),52754,52498,87.1,14.2,8.3,4.3,4.3,1.9,4.0,6.5,12.4,2.0,97.3,45963,7492,4394,1025,2120,3438,6535,2283,2283,1064,51312,18607,78.8,8.3,35.3,1.9,2.1,2.5,5.9,41569,4394,1025,1095,1318,3097
E14000896,RICHMOND PARK,54445,54376,98.1,85.6,82.5,6.5,6.5,0.0,0.0,0.1,1.8,0.1,98.4,53401,46616,44907,0,16,68,975,3555,3555,69,53549,0,15.6,82.5,0.0,0.0,0.0,0.1,1.7,8494,44907,0,16,52,907
E14000897,ROCHDALE,49852,49743,98.1,73.2,66.3,16.7,16.7,0.0,0.1,0.5,1.6,0.3,99.5,48928,36490,33033,10,54,257,815,8320,8320,129,49581,0,31.9,66.3,0.0,0.0,0.1,0.4,1.1,15895,33033,10,44,203,558
E14000898,ROCHESTER AND STROOD,51562,51471,95.2,68.1,61.8,6.3,6.3,0.0,0.5,1.4,4.6,0.3,97.8,49111,35105,31863,24,247,699,2360,3223,3223,144,50407,0,33.5,61.8,0.0,0.0,0.4,0.9,3.2,17248,31863,24,223,452,1661
E14000899,ROCHFORD AND SOUTHEND EAST,51619,51414,96.0,77.3,73.2,26.7,26.7,0.0,0.1,0.2,3.6,0.3,96.5,49541,39913,37784,1,30,106,1873,13783,13783,178,49811,0,22.8,73.2,0.0,0.0,0.1,0.1,3.4,11757,37784,1,29,76,1767
E14000900,ROMFORD,46242,45815,96.6,85.8,82.8,5.8,5.8,0.0,0.0,0.3,2.4,0.9,96.9,44684,39674,38270,9,12,121,1131,2672,2672,433,44800,0,13.9,82.8,0.0,0.0,0.0,0.2,2.2,6414,38270,9,3,109,1010
E14000901,ROMSEY AND SOUTHAMPTON NORTH,40058,40005,92.9,66.6,64.8,10.1,32.8,0.3,0.8,1.9,7.0,0.6,98.5,37207,26667,25953,104,315,776,2798,4064,13140,227,39440,0,28.1,64.8,0.0,0.3,0.5,1.2,5.0,11254,25953,104,211,461,2022
E14000902,ROSSENDALE AND DARWEN,48759,48565,94.8,53.4,47.5,8.5,8.5,0.1,0.7,1.2,4.8,0.5,98.8,46219,26027,23165,49,345,562,2346,4144,4149,268,48171,7854,47.3,47.5,16.1,0.1,0.6,0.4,3.7,23054,23165,49,296,217,1784
E14000903,ROTHER VALLEY,45344,45296,97.7,46.2,40.8,9.3,9.3,0.1,0.2,0.5,2.1,0.2,99.5,44323,20951,18499,24,81,206,973,4234,4234,84,45117,525,57.0,40.8,1.2,0.1,0.1,0.3,1.7,25824,18499,24,57,125,767
E14000904,ROTHERHAM,42796,42740,98.4,79.0,78.9,3.7,3.7,0.0,0.1,0.2,1.5,0.1,99.4,42098,33820,33748,2,37,86,642,1594,1595,52,42521,0,19.5,78.9,0.0,0.0,0.1,0.1,1.3,8350,33748,2,35,49,556
E14000905,RUGBY,48068,47974,97.2,72.1,68.7,12.6,65.4,0.2,0.4,0.7,2.6,0.2,98.9,46719,34642,33010,118,199,337,1255,6062,31422,111,47530,0,28.5,68.7,0.0,0.2,0.2,0.3,1.9,13709,33010,118,81,138,918
E14000906,"RUISLIP, NORTHWOOD AND PINNER",42682,42565,98.0,79.3,77.1,6.1,6.1,0.0,0.1,0.4,1.7,0.3,98.5,41830,33856,32899,14,47,190,735,2607,2607,117,42056,0,20.9,77.1,0.0,0.0,0.1,0.3,1.3,8931,32899,14,33,143,545
E14000907,RUNNYMEDE AND WEYBRIDGE,49402,49311,96.6,69.4,65.9,3.6,3.6,0.0,0.1,0.5,3.2,0.2,98.4,47726,34274,32573,8,27,264,1585,1798,1798,102,48624,0,30.7,65.9,0.0,0.0,0.0,0.5,2.7,15153,32573,8,19,237,1321
E14000908,RUSHCLIFFE,46092,46035,97.2,77.5,74.2,22.2,22.2,0.1,0.4,0.8,2.6,0.2,99.4,44814,35703,34192,64,167,356,1221,10222,10222,97,45813,131,23.0,74.2,0.3,0.1,0.2,0.4,1.9,10622,34192,64,103,189,865
E14000909,RUTLAND AND MELTON,49702,49567,92.3,30.7,30.4,7.5,7.5,0.6,1.5,2.5,7.4,0.9,97.9,45896,15238,15129,290,731,1250,3671,3707,3707,464,48674,582,61.9,30.4,1.2,0.6,0.9,1.0,4.9,30767,15129,290,441,519,2421
E14000910,SAFFRON WALDEN,52503,52277,87.9,34.1,32.4,19.4,19.4,0.4,1.6,4.2,11.7,1.4,93.9,46152,17896,17032,198,852,2180,6125,10186,10186,741,49290,0,55.5,32.4,0.0,0.4,1.2,2.5,7.5,29120,17032,198,654,1328,3945
E14000911,SALFORD AND ECCLES,66237,66134,94.0,77.5,77.3,53.0,77.3,0.0,1.1,3.0,5.8,0.2,94.2,62281,51312,51180,2,733,1962,3853,35092,51183,100,62392,0,16.8,77.3,0.0,0.0,1.1,1.9,2.9,11101,51180,2,731,1229,1891
E14000912,SALISBURY,47057,46994,96.7,67.8,67.8,56.0,56.0,0.1,0.4,0.8,3.1,0.3,99.5,45517,31920,31906,41,183,377,1477,26339,26339,155,46828,47,28.9,67.8,0.1,0.1,0.3,0.4,2.3,13611,31906,41,142,194,1100
E14000913,SCARBOROUGH AND WHITBY,55780,55691,93.0,2.8,2.8,2.8,2.8,0.6,1.3,1.9,6.8,0.7,97.8,51899,1578,1578,344,713,1071,3792,1575,1575,393,54560,1103,90.2,2.8,2.0,0.6,0.7,0.6,4.9,50321,1578,344,369,358,2721
E14000914,SCUNTHORPE,42390,42304,97.5,72.5,72.4,0.8,0.8,0.4,0.8,1.2,2.3,0.3,98.9,41319,30720,30700,157,325,498,985,357,357,115,41904,22299,25.1,72.4,52.6,0.4,0.4,0.4,1.1,10619,30700,157,168,173,487
E14000915,SEDGEFIELD,42284,42210,89.7,20.0,12.5,4.4,4.4,0.9,2.2,3.7,10.2,0.6,96.2,37915,8448,5301,370,912,1583,4295,1846,1846,239,40678,2381,77.1,12.5,5.6,0.9,1.3,1.6,6.4,32614,5301,370,542,671,2712
E14000916,SEFTON CENTRAL,38972,38890,97.4,75.9,75.8,36.3,75.8,0.1,0.3,0.5,2.4,0.2,99.5,37942,29570,29547,47,98,192,948,14153,29547,88,38771,0,21.5,75.8,0.0,0.1,0.1,0.2,1.9,8395,29547,47,51,94,756
E14000917,SELBY AND AINSTY,48623,48400,89.9,18.7,18.6,18.4,18.5,1.1,2.0,3.0,9.7,0.9,97.8,43698,9098,9053,526,982,1478,4702,8952,9004,414,47551,8007,71.3,18.6,16.5,1.1,0.9,1.0,6.6,34645,9053,526,456,496,3224
E14000918,SEVENOAKS,43213,43164,93.9,40.6,40.6,17.5,17.5,0.1,0.4,1.0,6.0,0.3,99.6,40571,17554,17545,47,171,450,2593,7583,7583,133,43040,0,53.3,40.6,0.0,0.1,0.3,0.6,5.0,23026,17545,47,124,279,2143
E14000919,SHEFFIELD CENTRAL,58596,58291,91.3,66.1,62.1,8.4,8.4,0.0,0.0,0.6,8.1,0.5,91.5,53525,38713,36360,1,18,373,4766,4945,4946,305,53614,287,29.3,62.1,0.5,0.0,0.0,0.6,7.5,17165,36360,1,17,355,4393
E14000920,SHEFFIELD SOUTH EAST,44658,44596,97.1,41.1,32.0,2.3,2.3,0.0,0.2,0.5,2.7,0.2,98.4,43374,18346,14297,4,83,211,1222,1017,1017,68,43943,0,65.1,32.0,0.0,0.0,0.2,0.3,2.3,29077,14297,4,79,128,1011
E14000921,"SHEFFIELD, BRIGHTSIDE AND HILLSBOROUGH",48704,48671,99.1,74.5,74.4,1.3,1.3,0.0,0.0,0.5,0.9,0.1,99.3,48250,36283,36232,1,24,224,421,612,612,33,48341,0,24.7,74.4,0.0,0.0,0.0,0.4,0.4,12018,36232,1,23,200,197
E14000922,"SHEFFIELD, HALLAM",39111,39096,96.8,27.9,23.6,7.7,7.7,0.1,0.2,0.3,3.2,0.1,99.6,37853,10905,9216,41,78,127,1243,3027,3027,52,38970,0,73.2,23.6,0.0,0.1,0.1,0.1,2.9,28637,9216,41,37,49,1116
E14000923,"SHEFFIELD, HEELEY",45360,45335,99.0,56.6,53.5,2.8,2.8,0.0,0.0,0.0,1.0,0.1,99.5,44888,25658,24289,0,1,4,447,1254,1254,25,45154,0,45.4,53.5,0.0,0.0,0.0,0.0,1.0,20599,24289,0,1,3,443
E14000924,SHERWOOD,48047,47934,97.1,68.6,67.6,11.6,11.6,0.1,0.4,0.6,2.6,0.3,99.4,46663,32982,32494,57,204,312,1271,5563,5564,153,47750,0,29.5,67.6,0.0,0.1,0.3,0.2,2.0,14169,32494,57,147,108,959
E14000925,SHIPLEY,43564,43544,96.5,71.0,66.4,6.1,63.1,0.1,0.2,0.5,3.5,0.1,98.4,42025,30945,28914,52,106,197,1519,2644,27500,24,42870,14087,30.1,66.4,32.3,0.1,0.1,0.2,3.0,13111,28914,52,54,91,1322
E14000926,SHREWSBURY AND ATCHAM,51748,51576,90.5,29.9,17.6,8.7,8.7,0.5,1.7,3.5,9.2,0.6,96.0,46832,15471,9109,234,862,1817,4744,4513,4513,286,49695,45081,72.9,17.6,87.1,0.5,1.2,1.8,5.7,37723,9109,234,628,955,2927
E14000927,SITTINGBOURNE AND SHEPPEY,53343,53185,94.2,51.6,43.2,6.2,6.2,0.2,0.6,1.5,5.5,0.4,98.8,50268,27512,23059,114,337,780,2917,3312,3312,195,52692,0,51.0,43.2,0.0,0.2,0.4,0.8,4.0,27209,23059,114,223,443,2137
E14000928,SKIPTON AND RIPON,50837,50656,88.5,18.4,14.8,11.3,11.3,1.6,3.3,5.1,11.1,1.4,96.8,44994,9355,7508,791,1694,2588,5662,5746,5759,727,49230,13052,73.7,14.8,25.7,1.6,1.8,1.8,6.0,37486,7508,791,903,894,3074
E14000929,SLEAFORD AND NORTH HYKEHAM,56261,56125,92.5,28.6,26.9,4.4,4.4,0.8,1.7,2.5,7.2,0.7,98.0,52068,16115,15149,470,949,1390,4057,2468,2468,399,55132,1818,65.6,26.9,3.2,0.8,0.9,0.8,4.7,36919,15149,470,479,441,2667
E14000930,SLOUGH,54731,54620,98.9,90.7,86.8,16.1,16.1,0.0,0.1,0.2,0.9,0.2,99.2,54146,49629,47488,10,48,134,474,8797,8797,107,54278,0,12.2,86.8,0.0,0.0,0.1,0.2,0.6,6658,47488,10,38,86,340
E14000931,SOLIHULL,45251,45207,98.1,92.7,91.6,35.3,90.5,0.0,0.0,0.6,1.8,0.1,98.2,44400,41933,41433,0,3,264,807,15981,40932,44,44414,1,6.6,91.6,0.0,0.0,0.0,0.6,1.2,2967,41433,0,3,261,543
E14000932,SOMERTON AND FROME,53503,53126,81.6,25.6,24.5,5.4,5.4,0.7,3.5,7.9,17.7,2.3,93.2,43657,13702,13103,354,1851,4234,9469,2873,2873,1224,49883,3619,57.1,24.5,6.8,0.7,2.8,4.5,9.8,30554,13103,354,1497,2383,5235
E14000933,SOUTH BASILDON AND EAST THURROCK,44587,44496,96.1,68.2,66.6,4.5,4.5,0.1,0.5,1.0,3.7,0.3,98.9,42833,30413,29694,30,228,448,1663,2000,2000,145,44118,0,29.5,66.6,0.0,0.1,0.4,0.5,2.7,13139,29694,30,198,220,1215
E14000934,SOUTH CAMBRIDGESHIRE,53050,52978,95.3,56.6,54.7,18.0,18.0,0.2,0.6,1.5,4.6,0.3,98.3,50555,30007,28997,117,302,781,2423,9555,9555,145,52142,190,40.6,54.7,0.4,0.2,0.3,0.9,3.1,21558,28997,117,185,479,1642
E14000935,SOUTH DERBYSHIRE,48496,48291,94.0,32.3,27.0,16.9,16.9,0.2,1.1,1.5,5.6,0.7,98.7,45583,15677,13101,113,530,749,2708,8193,8193,339,47845,0,67.0,27.0,0.0,0.2,0.9,0.5,4.0,32482,13101,113,417,219,1959
E14000936,SOUTH DORSET,49658,49205,95.3,3.4,3.4,3.4,3.4,0.3,0.5,0.9,3.8,1.3,98.5,47319,1706,1706,125,258,431,1886,1706,1706,659,48934,0,91.9,3.4,0.0,0.3,0.3,0.3,2.9,45613,1706,125,133,173,1455
E14000937,SOUTH EAST CAMBRIDGESHIRE,53959,53660,95.0,52.9,49.0,12.4,12.4,0.3,0.6,1.3,4.4,0.7,98.7,51275,28533,26461,159,323,724,2385,6703,6703,388,53278,8822,46.0,49.0,16.3,0.3,0.3,0.7,3.1,24814,26461,159,164,401,1661
E14000938,SOUTH EAST CORNWALL,48140,47915,89.0,33.8,33.2,20.0,20.0,0.5,1.2,2.4,10.5,0.9,95.1,42862,16285,15967,229,576,1135,5053,9617,9617,443,45798,7880,55.9,33.2,16.4,0.5,0.7,1.2,8.1,26895,15967,229,347,559,3918
E14000939,SOUTH HOLLAND AND THE DEEPINGS,50446,50282,89.1,10.3,7.5,5.6,5.6,0.4,1.6,3.0,10.6,1.1,98.7,44941,5213,3759,214,795,1506,5341,2803,2803,567,49783,231,81.6,7.5,0.5,0.4,1.2,1.4,7.6,41182,3759,214,581,711,3835
E14000940,SOUTH LEICESTERSHIRE,48809,48731,96.4,61.2,57.8,38.0,38.0,0.2,0.4,0.6,3.4,0.2,98.2,47076,29884,28214,88,195,302,1655,18530,18530,102,47935,0,38.6,57.8,0.0,0.2,0.2,0.2,2.8,18862,28214,88,107,107,1353
E14000941,SOUTH NORFOLK,51901,51794,90.0,11.9,10.6,8.4,8.4,0.4,1.5,3.0,9.8,1.5,98.0,46711,6157,5484,215,787,1557,5083,4369,4369,800,50881,0,79.4,10.6,0.0,0.4,1.1,1.5,6.8,41227,5484,215,572,770,3526
E14000942,SOUTH NORTHAMPTONSHIRE,55132,54690,93.9,50.1,43.5,34.0,34.0,0.2,1.6,2.4,5.3,1.2,96.5,51749,27615,23958,84,882,1305,2941,18745,18745,682,53194,320,50.4,43.5,0.6,0.2,1.4,0.8,3.0,27791,23958,84,798,423,1636
E14000943,SOUTH RIBBLE,45874,45776,95.4,63.2,60.4,15.4,15.4,0.1,0.5,1.2,4.4,0.3,98.8,43746,29000,27685,39,225,533,2030,7081,7081,116,45338,4987,35.0,60.4,10.9,0.1,0.4,0.7,3.3,16061,27685,39,186,308,1497
E14000944,SOUTH SHIELDS,42453,42436,98.5,83.0,82.4,0.9,0.9,0.0,0.2,0.3,1.4,0.0,99.0,41821,35232,34973,16,65,128,615,379,379,17,42030,0,16.1,82.4,0.0,0.0,0.1,0.1,1.1,6848,34973,16,49,63,487
E14000945,SOUTH STAFFORDSHIRE,42853,42802,93.7,40.6,35.4,31.9,32.1,0.2,0.7,1.6,6.2,0.2,99.2,40154,17395,15171,74,292,688,2648,13689,13761,72,42514,2376,58.3,35.4,5.5,0.2,0.5,0.9,4.6,24983,15171,74,218,396,1960
E14000946,SOUTH SUFFOLK,45315,45152,93.5,12.6,12.3,8.4,8.4,0.4,0.8,1.3,6.2,0.8,98.9,42351,5696,5561,163,370,599,2801,3803,3803,345,44794,0,81.2,12.3,0.0,0.4,0.5,0.5,4.9,36790,5561,163,207,229,2202
E14000947,SOUTH SWINDON,49245,49217,90.9,84.9,82.6,11.2,11.2,0.0,0.6,2.0,9.1,0.7,91.3,44756,41788,40683,13,315,963,4461,5510,5510,359,44977,0,8.3,82.6,0.0,0.0,0.6,1.3,7.1,4073,40683,13,302,648,3498
E14000948,SOUTH THANET,50932,50705,96.0,42.0,41.8,41.9,41.9,0.1,0.4,1.1,3.6,0.6,98.8,48890,21411,21299,50,198,545,1815,21322,21322,295,50325,0,54.2,41.8,0.0,0.1,0.3,0.7,2.5,27591,21299,50,148,347,1270
E14000949,SOUTH WEST BEDFORDSHIRE,49827,49777,98.2,74.1,71.9,8.0,8.0,0.0,0.0,0.3,1.7,0.2,99.3,48930,36942,35816,10,22,154,847,3968,3968,122,49494,0,26.3,71.9,0.0,0.0,0.0,0.3,1.4,13114,35816,10,12,132,693
E14000950,SOUTH WEST DEVON,43444,43373,91.8,72.2,71.2,17.1,17.1,0.2,1.0,3.5,8.1,0.8,96.7,39860,31364,30933,69,417,1526,3513,7449,7449,333,42001,13148,20.5,71.2,30.3,0.2,0.8,2.6,4.6,8927,30933,69,348,1109,1987
E14000951,SOUTH WEST HERTFORDSHIRE,47942,47876,96.0,70.0,68.7,4.6,4.6,0.2,0.4,0.8,3.8,0.3,99.4,46048,33541,32930,74,171,369,1828,2222,2222,123,47655,0,27.4,68.7,0.0,0.2,0.2,0.4,3.0,13118,32930,74,97,198,1459
E14000952,SOUTH WEST NORFOLK,52010,51730,89.6,10.3,8.2,5.9,5.9,0.9,2.0,3.4,9.8,1.8,98.0,46612,5381,4289,454,1025,1772,5118,3043,3043,923,50944,2397,81.4,8.2,4.6,0.9,1.1,1.4,6.4,42323,4289,454,571,747,3346
E14000953,SOUTH WEST SURREY,47699,47647,95.0,20.7,16.5,3.7,3.7,0.1,0.2,0.4,4.9,0.3,99.6,45332,9854,7885,24,86,208,2315,1769,1769,142,47523,0,78.5,16.5,0.0,0.1,0.1,0.3,4.4,37447,7885,24,62,122,2107
E14000954,SOUTH WEST WILTSHIRE,49489,49419,94.3,54.0,53.9,5.7,5.7,0.4,0.8,1.4,5.6,0.4,98.3,46654,26738,26663,178,409,713,2765,2839,2839,184,48661,2277,40.4,53.9,4.6,0.4,0.5,0.6,4.1,19991,26663,178,231,304,2052
E14000955,"SOUTHAMPTON, ITCHEN",52664,52376,95.5,88.4,82.4,14.3,76.3,0.0,0.0,0.6,3.9,0.5,95.7,50318,46534,43418,0,16,331,2058,7537,40180,288,50411,0,13.1,82.4,0.0,0.0,0.0,0.6,3.3,6900,43418,0,16,315,1727
E14000956,"SOUTHAMPTON, TEST",50963,50801,97.4,92.5,90.4,7.6,82.1,0.0,0.0,0.6,2.3,0.3,97.4,49630,47151,46071,0,10,292,1171,3896,41838,166,49655,0,7.0,90.4,0.0,0.0,0.0,0.6,1.7,3559,46071,0,10,282,879
E14000957,SOUTHEND WEST,42876,42827,97.8,62.2,52.7,13.0,13.0,0.0,0.0,0.0,2.1,0.1,98.4,41915,26668,22594,0,1,5,912,5579,5579,49,42175,0,45.1,52.7,0.0,0.0,0.0,0.0,2.1,19321,22594,0,1,4,907
E14000958,SOUTHPORT,46336,46172,98.0,47.4,31.8,1.1,16.9,0.0,0.0,0.0,1.6,0.4,99.4,45416,21960,14738,0,21,23,756,496,7836,165,46068,0,66.2,31.8,0.0,0.0,0.0,0.0,1.6,30678,14738,0,21,2,733
E14000959,SPELTHORNE,44809,44666,97.0,84.0,82.6,23.0,23.0,0.0,0.0,0.6,2.7,0.3,97.6,43473,37624,37001,0,10,290,1193,10315,10315,142,43752,0,14.4,82.6,0.0,0.0,0.0,0.6,2.0,6472,37001,0,10,280,903
E14000960,ST ALBANS,45759,45708,97.4,85.0,82.2,27.8,27.8,0.0,0.0,0.0,2.5,0.1,98.9,44549,38909,37622,1,5,17,1159,12715,12715,52,45242,0,15.1,82.2,0.0,0.0,0.0,0.0,2.5,6927,37622,1,4,12,1142
E14000961,ST AUSTELL AND NEWQUAY,54320,54067,89.9,35.5,28.8,24.3,24.3,0.1,0.7,1.5,9.6,0.8,94.2,48845,19292,15636,72,380,805,5222,13193,13193,422,51177,0,61.1,28.8,0.0,0.1,0.6,0.8,8.1,33209,15636,72,308,425,4417
E14000962,ST HELENS NORTH,47113,47067,97.7,82.7,82.6,2.6,78.4,0.1,0.4,0.7,2.2,0.2,99.5,46031,38943,38896,24,206,351,1036,1207,36938,73,46890,1052,15.1,82.6,2.2,0.1,0.4,0.3,1.5,7135,38896,24,182,145,685
E14000963,ST HELENS SOUTH AND WHISTON,51600,51511,97.8,81.8,80.6,6.5,80.4,0.1,0.3,0.4,2.0,0.1,99.0,50474,42188,41611,39,153,216,1037,3365,41484,74,51102,0,17.2,80.6,0.0,0.1,0.2,0.1,1.6,8863,41611,39,114,63,821
E14000964,ST IVES,50451,50189,87.8,33.6,33.6,33.6,33.6,0.2,0.8,1.9,11.7,1.2,93.4,44291,16964,16964,126,400,961,5898,16964,16964,592,47130,0,54.2,33.6,0.0,0.2,0.5,1.1,9.8,27327,16964,126,274,561,4937
E14000965,STAFFORD,47127,47080,95.5,67.7,67.4,4.3,8.2,0.2,0.5,1.3,4.4,0.2,98.4,44996,31886,31777,87,258,603,2084,2049,3872,83,46380,332,28.0,67.4,0.7,0.2,0.4,0.7,3.1,13219,31777,87,171,345,1481
E14000966,STAFFORDSHIRE MOORLANDS,37447,37353,90.7,35.0,33.5,3.1,3.1,0.8,2.0,4.0,9.1,1.4,98.2,33960,13091,12555,283,738,1492,3393,1170,1170,541,36768,0,57.2,33.5,0.0,0.8,1.2,2.0,5.1,21405,12555,283,455,754,1901
E14000967,STALYBRIDGE AND HYDE,48401,48217,95.4,22.2,22.0,13.1,13.1,0.0,0.0,0.3,4.2,0.4,99.5,46171,10728,10633,2,18,124,2046,6323,6323,183,48136,0,73.4,22.0,0.0,0.0,0.0,0.2,4.0,35538,10633,2,16,106,1922
E14000968,STEVENAGE,44293,44233,98.7,82.2,82.0,2.2,2.2,0.0,0.0,0.2,1.2,0.1,99.2,43697,36416,36299,0,21,72,536,958,958,63,43943,0,16.7,82.0,0.0,0.0,0.0,0.1,1.0,7398,36299,0,21,51,464
E14000969,STOCKPORT,44476,44376,98.9,85.1,84.9,1.4,38.6,0.0,0.0,0.0,0.8,0.2,99.0,44006,37848,37760,1,4,7,370,631,17174,99,44037,0,14.0,84.9,0.0,0.0,0.0,0.0,0.8,6246,37760,1,3,3,363
E14000970,STOCKTON NORTH,44357,44308,95.4,89.0,88.7,2.7,2.7,0.1,0.6,1.7,4.5,0.3,96.6,42303,39488,39349,55,286,744,2005,1188,1188,111,42843,1034,6.7,88.7,2.3,0.1,0.5,1.0,2.8,2954,39349,55,231,458,1261
E14000971,STOCKTON SOUTH,46983,46967,96.4,87.2,80.0,6.5,6.5,0.0,0.3,1.5,3.6,0.1,96.6,45295,40989,37578,22,158,698,1672,3044,3044,54,45409,2140,16.4,80.0,4.6,0.0,0.3,1.1,2.1,7717,37578,22,136,540,974
E14000972,STOKE-ON-TRENT CENTRAL,42658,42589,97.7,86.2,86.1,0.7,0.7,0.0,0.0,0.3,2.1,0.2,98.0,41683,36770,36742,1,19,114,906,299,299,69,41784,0,11.6,86.1,0.0,0.0,0.0,0.2,1.9,4941,36742,1,18,95,792
E14000973,STOKE-ON-TRENT NORTH,47398,47346,98.2,82.4,79.5,8.1,8.1,0.0,0.0,0.5,1.7,0.1,98.9,46553,39033,37704,0,14,223,793,3845,3845,50,46857,0,18.7,79.5,0.0,0.0,0.0,0.4,1.2,8849,37704,0,14,209,570
E14000974,STOKE-ON-TRENT SOUTH,42469,42434,97.4,59.8,59.7,1.6,1.6,0.0,0.1,0.4,2.5,0.1,99.4,41357,25391,25358,0,43,156,1077,690,690,36,42193,0,37.7,59.7,0.0,0.0,0.1,0.3,2.2,15999,25358,0,43,113,921
E14000975,STONE,41133,41032,89.7,24.5,24.5,8.4,8.4,0.4,1.6,3.4,10.1,0.9,97.8,36881,10071,10066,153,673,1411,4151,3467,3467,351,40226,1646,65.2,24.5,4.0,0.4,1.3,1.8,6.7,26815,10066,153,520,738,2740
E14000976,STOURBRIDGE,41601,41546,99.0,91.0,90.1,3.4,89.2,0.0,0.0,0.0,0.8,0.1,99.8,41200,37853,37480,1,5,8,346,1425,37124,53,41507,167,8.9,90.1,0.4,0.0,0.0,0.0,0.8,3720,37480,1,4,3,338
E14000977,STRATFORD-ON-AVON,48392,48094,93.6,39.9,36.7,12.2,33.6,0.4,1.2,2.0,5.8,0.8,98.1,45279,19317,17779,174,561,969,2815,5918,16253,400,47463,46,56.8,36.7,0.1,0.4,0.8,0.8,3.8,27500,17779,174,387,408,1846
E14000978,STREATHAM,53426,53264,95.0,66.5,58.1,8.3,8.3,0.0,0.0,0.0,4.7,0.3,95.4,50776,35502,31017,0,0,3,2488,4423,4423,136,50978,0,37.0,58.1,0.0,0.0,0.0,0.0,4.7,19759,31017,0,0,3,2485
E14000979,STRETFORD AND URMSTON,47540,47344,98.4,65.0,63.4,3.5,62.5,0.0,0.1,0.2,1.2,0.4,98.9,46793,30916,30138,3,64,117,551,1656,29715,195,47008,0,35.0,63.4,0.0,0.0,0.1,0.1,0.9,16655,30138,3,61,53,434
E14000980,STROUD,50749,50645,90.4,14.6,14.5,10.5,10.5,0.4,1.2,2.5,9.4,0.4,94.6,45868,7391,7373,193,597,1263,4777,5314,5314,179,48029,184,75.9,14.5,0.4,0.4,0.8,1.3,6.9,38495,7373,193,404,666,3514
E14000981,SUFFOLK COASTAL,57269,57108,93.1,24.0,24.0,12.0,12.0,0.3,0.9,1.9,6.6,1.0,98.2,53318,13740,13718,146,522,1066,3790,6886,6886,550,56249,0,69.1,24.0,0.0,0.3,0.7,0.9,4.8,39600,13718,146,376,544,2724
E14000982,SUNDERLAND CENTRAL,51138,51003,97.2,58.7,53.3,4.0,4.0,0.0,0.1,0.5,2.6,0.3,97.6,49692,30035,27250,25,49,245,1311,2043,2043,135,49906,0,43.9,53.3,0.0,0.0,0.0,0.4,2.1,22442,27250,25,24,196,1066
E14000983,SURREY HEATH,47309,47273,98.0,69.4,68.7,6.4,6.4,0.0,0.0,0.2,1.9,0.1,99.7,46367,32834,32517,1,16,90,906,3039,3039,36,47178,0,29.3,68.7,0.0,0.0,0.0,0.2,1.7,13850,32517,1,15,74,816
E14000984,SUTTON AND CHEAM,44741,44691,98.2,86.8,79.7,7.4,7.4,0.0,0.0,0.0,1.7,0.1,98.3,43948,38848,35679,0,6,8,743,3312,3312,49,43968,0,18.5,79.7,0.0,0.0,0.0,0.0,1.6,8269,35679,0,6,2,735
E14000985,SUTTON COLDFIELD,43446,43418,98.0,85.7,85.0,38.7,84.7,0.0,0.1,0.5,1.9,0.1,98.2,42591,37216,36923,3,41,198,827,16834,36789,64,42672,0,13.0,85.0,0.0,0.0,0.1,0.4,1.4,5668,36923,3,38,157,629
E14000986,TAMWORTH,43820,43720,97.2,77.0,73.7,6.0,71.3,0.3,0.4,0.9,2.6,0.3,99.5,42578,33736,32289,127,189,382,1142,2629,31225,120,43597,0,23.5,73.7,0.0,0.3,0.1,0.4,1.7,10289,32289,127,62,193,760
E14000987,TATTON,42452,42371,92.6,53.3,47.1,7.1,42.8,0.3,0.9,1.8,7.2,0.4,98.6,39327,22644,20016,138,363,769,3044,3027,18167,177,41842,0,45.5,47.1,0.0,0.3,0.5,1.0,5.4,19311,20016,138,225,406,2275
E14000988,TAUNTON DEANE,57893,57757,89.4,29.6,16.7,6.3,6.3,0.5,2.1,4.3,10.4,1.4,95.8,51739,17132,9694,313,1203,2486,6018,3620,3620,804,55457,18,72.6,16.7,0.0,0.5,1.5,2.2,6.1,42045,9694,313,890,1283,3532
E14000989,TELFORD,45594,45517,98.4,82.9,80.2,7.9,7.9,0.0,0.0,0.1,1.4,0.2,98.9,44880,37810,36589,0,2,49,637,3601,3601,78,45082,19768,18.2,80.2,43.4,0.0,0.0,0.1,1.3,8291,36589,0,2,47,588
E14000990,TEWKESBURY,54102,53619,92.1,61.5,58.5,20.6,20.6,0.3,1.1,2.0,7.1,1.3,93.7,49801,33270,31643,141,590,1095,3818,11157,11157,702,50695,0,33.6,58.5,0.0,0.3,0.8,0.9,5.0,18158,31643,141,449,505,2723
E14000991,THE COTSWOLDS,53290,53182,91.2,37.2,37.0,37.0,37.0,0.2,1.0,2.2,8.6,1.0,94.5,48607,19831,19736,128,517,1182,4575,19692,19692,529,50346,67,54.2,37.0,0.1,0.2,0.7,1.2,6.4,28871,19736,128,389,665,3393
E14000992,THE WREKIN,44169,44031,95.3,73.9,71.1,2.9,2.9,0.2,0.7,1.4,4.4,0.5,99.1,42105,32655,31418,96,291,627,1926,1282,1282,206,43773,16408,24.2,71.1,37.1,0.2,0.4,0.8,2.9,10687,31418,96,195,336,1299
E14000993,THIRSK AND MALTON,54516,54087,86.4,7.3,7.3,7.3,7.3,2.1,4.3,6.7,12.8,2.2,95.6,47109,3974,3974,1129,2319,3660,6978,3972,3972,1194,52118,9484,79.1,7.3,17.4,2.1,2.2,2.5,6.1,43135,3974,1129,1190,1341,3318
E14000994,THORNBURY AND YATE,39882,39813,96.9,69.1,68.7,15.2,15.2,0.3,0.5,1.1,2.9,0.5,99.4,38652,27570,27395,104,213,423,1161,6058,6058,183,39657,0,28.2,68.7,0.0,0.3,0.3,0.5,1.9,11257,27395,104,109,210,738
E14000995,THURROCK,53323,53294,96.3,83.4,81.7,16.3,16.3,0.0,0.3,1.5,3.6,0.1,97.0,51366,44468,43551,9,147,797,1928,8696,8696,56,51702,0,14.7,81.7,0.0,0.0,0.3,1.2,2.1,7815,43551,9,138,650,1131
E14000996,TIVERTON AND HONITON,50953,50770,82.3,4.3,4.2,4.2,4.2,1.0,3.8,7.8,17.4,2.1,94.0,41924,2167,2161,491,1920,3994,8846,2161,2161,1067,47885,131,78.0,4.2,0.3,1.0,2.8,4.1,9.5,39763,2161,491,1429,2074,4852
E14000997,TONBRIDGE AND MALLING,46582,46499,92.1,53.7,52.1,12.6,12.6,0.4,0.9,1.7,7.8,0.6,98.3,42880,25025,24259,179,397,784,3619,5857,5857,273,45804,0,40.0,52.1,0.0,0.4,0.5,0.8,6.1,18621,24259,179,218,387,2835
E14000998,TOOTING,47997,47872,96.4,78.5,73.7,25.4,25.4,0.0,0.0,0.2,3.4,0.2,96.4,46263,37685,35383,0,0,115,1609,12209,12209,102,46274,0,22.7,73.7,0.0,0.0,0.0,0.2,3.1,10880,35383,0,0,115,1494
E14000999,TORBAY,58775,58481,94.5,78.7,72.8,27.2,27.2,0.0,0.0,0.2,5.0,0.5,95.7,55522,46250,42807,1,2,92,2959,15960,15960,300,56277,0,21.6,72.8,0.0,0.0,0.0,0.2,4.9,12715,42807,1,1,90,2867
E14001000,TORRIDGE AND WEST DEVON,50632,50388,80.1,7.2,7.2,7.2,7.2,2.1,6.5,11.3,19.5,2.0,93.3,40540,3628,3627,1040,3273,5712,9848,3627,3627,1031,47252,27393,72.9,7.2,54.1,2.1,4.4,4.8,8.2,36913,3627,1040,2233,2439,4136
E14001001,TOTNES,50391,50163,85.2,15.5,13.9,10.0,10.0,0.6,2.1,4.8,14.3,1.8,95.3,42957,7812,6999,322,1042,2437,7206,5048,5048,901,48014,6161,71.4,13.9,12.2,0.6,1.4,2.8,9.5,35958,6999,322,720,1395,4769
E14001002,TOTTENHAM,53762,53708,98.9,88.9,87.9,4.2,4.2,0.0,0.0,0.2,1.0,0.1,98.9,53181,47810,47273,0,12,124,527,2240,2240,54,53191,0,11.0,87.9,0.0,0.0,0.0,0.2,0.7,5908,47273,0,12,112,403
E14001003,TRURO AND FALMOUTH,50608,50382,86.8,34.7,34.5,34.3,34.3,0.2,0.6,1.7,12.8,1.1,91.5,43915,17544,17441,80,295,853,6467,17335,17335,532,46312,0,52.3,34.5,0.0,0.2,0.4,1.1,11.1,26474,17441,80,215,558,5614
E14001004,TUNBRIDGE WELLS,48207,48123,92.9,53.4,48.9,8.6,8.6,0.1,0.8,2.0,6.9,0.8,98.3,44808,25728,23555,47,394,953,3315,4168,4168,365,47406,0,44.1,48.9,0.0,0.1,0.7,1.2,4.9,21253,23555,47,347,559,2362
E14001005,TWICKENHAM,52044,51950,98.6,88.0,86.4,21.8,21.8,0.0,0.0,0.2,1.3,0.2,98.7,51290,45810,44956,0,3,126,660,11323,11323,95,51352,0,12.2,86.4,0.0,0.0,0.0,0.2,1.0,6334,44956,0,3,123,534
E14001006,TYNEMOUTH,48691,48608,98.5,84.7,82.6,6.4,6.4,0.0,0.3,0.5,1.3,0.3,99.0,47974,41248,40215,22,131,226,634,3126,3126,129,48226,0,15.9,82.6,0.0,0.0,0.2,0.2,0.8,7759,40215,22,109,95,408
E14001007,UXBRIDGE AND SOUTH RUISLIP,45520,45072,94.7,81.4,81.0,4.9,4.9,0.0,0.4,0.9,4.3,1.0,94.8,43107,37065,36889,19,199,393,1965,2233,2233,449,43150,0,13.7,81.0,0.0,0.0,0.4,0.4,3.5,6218,36889,19,180,194,1572
E14001008,VAUXHALL,63917,63710,97.1,80.6,76.5,18.0,18.0,0.0,0.0,0.0,2.6,0.3,97.2,62078,51532,48866,0,0,0,1632,11514,11514,202,62103,0,20.7,76.5,0.0,0.0,0.0,0.0,2.6,13212,48866,0,0,0,1632
E14001009,WAKEFIELD,45141,45001,96.3,71.1,70.8,17.9,17.9,0.0,0.0,0.3,3.4,0.3,97.6,43480,32075,31952,1,7,153,1521,8078,8079,145,44052,0,25.5,70.8,0.0,0.0,0.0,0.3,3.0,11528,31952,1,6,146,1368
E14001010,WALLASEY,43826,43793,99.5,90.4,90.3,82.9,82.9,0.0,0.0,0.0,0.4,0.1,99.7,43608,39627,39553,1,2,3,185,36326,36327,38,43705,0,9.3,90.3,0.0,0.0,0.0,0.0,0.4,4055,39553,1,1,1,182
E14001011,WALSALL NORTH,42473,42445,98.5,85.0,82.9,7.1,81.6,0.0,0.0,0.9,1.4,0.1,98.8,41848,36093,35231,1,1,362,597,3023,34663,47,41953,0,15.6,82.9,0.0,0.0,0.0,0.8,0.6,6617,35231,1,0,361,235
E14001012,WALSALL SOUTH,42021,41971,98.4,66.5,65.7,9.8,62.0,0.0,0.0,0.2,1.4,0.1,99.3,41363,27929,27608,0,12,68,608,4099,26067,49,41733,0,32.7,65.7,0.0,0.0,0.0,0.1,1.3,13755,27608,0,12,56,540
E14001013,WALTHAMSTOW,48796,48755,96.7,89.5,87.1,24.8,24.8,0.0,0.0,0.3,3.2,0.1,96.8,47209,43664,42523,0,0,166,1546,12092,12092,41,47246,0,9.6,87.1,0.0,0.0,0.0,0.3,2.8,4686,42523,0,0,166,1380
E14001014,WANSBECK,40648,40630,96.8,10.6,6.2,3.2,3.2,0.0,0.1,0.2,3.1,0.1,99.8,39358,4300,2512,14,51,78,1272,1303,1303,25,40567,0,90.6,6.2,0.0,0.0,0.1,0.1,2.9,36846,2512,14,37,27,1194
E14001015,WANTAGE,57740,57493,96.0,58.7,56.2,21.8,21.8,0.1,0.4,0.9,3.6,0.5,99.1,55422,33919,32474,63,209,500,2071,12608,12608,287,57201,0,39.7,56.2,0.0,0.1,0.3,0.5,2.7,22948,32474,63,146,291,1571
E14001016,WARLEY,41366,41331,99.4,85.0,83.4,33.5,82.5,0.0,0.0,0.1,0.5,0.1,99.5,41128,35175,34506,3,7,54,203,13869,34122,33,41166,0,16.0,83.4,0.0,0.0,0.0,0.1,0.4,6622,34506,3,4,47,149
E14001017,WARRINGTON NORTH,45748,45628,97.1,73.7,70.4,1.1,68.7,0.1,0.1,0.2,2.6,0.3,99.4,44442,33731,32188,26,43,99,1186,523,31426,125,45490,0,26.8,70.4,0.0,0.1,0.0,0.1,2.4,12254,32188,26,17,56,1087
E14001018,WARRINGTON SOUTH,53650,53515,96.8,68.9,61.7,2.6,58.6,0.0,0.1,0.2,3.0,0.3,99.0,51910,36991,33113,7,74,103,1605,1383,31419,153,53117,0,35.0,61.7,0.0,0.0,0.1,0.1,2.8,18797,33113,7,67,29,1502
E14001019,WARWICK AND LEAMINGTON,50568,50494,98.9,82.6,76.2,11.4,70.7,0.0,0.4,0.5,1.0,0.2,99.3,49992,41784,38513,5,196,255,502,5740,35735,88,50227,0,22.7,76.2,0.0,0.0,0.4,0.1,0.5,11479,38513,5,191,59,247
E14001020,WASHINGTON AND SUNDERLAND WEST,41939,41879,96.9,76.2,72.7,1.0,1.0,0.1,0.4,1.3,2.9,0.2,98.1,40655,31947,30484,53,183,528,1224,400,400,98,41156,0,24.3,72.7,0.0,0.1,0.3,0.8,1.7,10171,30484,53,130,345,696
E14001021,WATFORD,53253,52967,98.7,90.8,87.5,3.6,3.6,0.0,0.0,0.2,0.7,0.5,99.0,52584,48348,46580,1,25,116,383,1921,1921,286,52725,0,11.3,87.5,0.0,0.0,0.0,0.2,0.5,6004,46580,1,24,91,267
E14001022,WAVENEY,51714,51634,95.9,14.1,14.1,14.1,14.1,0.1,0.4,0.6,4.0,0.4,99.0,49590,7282,7281,52,184,285,2044,7281,7281,181,51194,0,81.8,14.1,0.0,0.1,0.3,0.2,3.4,42309,7281,52,132,101,1759
E14001023,WEALDEN,49090,48984,92.7,16.6,16.4,16.3,16.3,0.3,0.9,1.6,7.1,0.8,99.3,45485,8173,8052,128,437,776,3499,8012,8012,396,48744,0,76.3,16.4,0.0,0.3,0.6,0.7,5.5,37433,8052,128,309,339,2723
E14001024,WEAVER VALE,44052,43990,95.6,33.8,27.3,5.7,5.7,0.2,0.4,0.8,4.2,0.2,99.4,42120,14906,12036,88,175,357,1870,2503,2504,98,43803,0,68.3,27.3,0.0,0.2,0.2,0.4,3.4,30084,12036,88,87,182,1513
E14001025,WELLINGBOROUGH,52768,52740,98.2,67.0,66.7,4.2,4.2,0.0,0.2,0.5,1.8,0.1,99.2,51815,35339,35210,8,115,277,925,2210,2210,45,52330,5030,31.5,66.7,9.5,0.0,0.2,0.3,1.2,16605,35210,8,107,162,648
E14001026,WELLS,52723,52578,88.6,21.5,12.2,5.3,5.3,0.6,1.7,3.1,11.1,1.0,96.1,46730,11361,6416,328,886,1645,5848,2798,2798,551,50643,0,76.5,12.2,0.0,0.6,1.1,1.4,8.0,40314,6416,328,558,759,4203
E14001027,WELWYN HATFIELD,47675,47642,97.5,76.8,74.6,9.7,9.7,0.0,0.1,0.3,2.4,0.1,99.4,46491,36617,35552,7,35,154,1151,4620,4620,36,47368,0,22.9,74.6,0.0,0.0,0.1,0.2,2.1,10939,35552,7,28,119,997
E14001028,WENTWORTH AND DEARNE,47769,47728,98.6,51.5,47.8,12.6,12.6,0.0,0.2,0.5,1.3,0.1,99.4,47085,24587,22828,4,100,236,643,6014,6015,57,47488,0,50.8,47.8,0.0,0.0,0.2,0.3,0.9,24257,22828,4,96,136,407
E14001029,WEST BROMWICH EAST,39963,39933,98.9,77.8,75.1,2.8,73.5,0.0,0.0,0.5,1.0,0.1,99.1,39539,31080,30030,1,4,206,394,1129,29363,30,39612,0,23.8,75.1,0.0,0.0,0.0,0.5,0.5,9509,30030,1,3,202,188
E14001030,WEST BROMWICH WEST,42450,42404,99.4,78.3,77.9,1.6,48.1,0.0,0.0,0.1,0.5,0.1,99.4,42179,33239,33054,0,9,63,225,659,20415,46,42203,0,21.5,77.9,0.0,0.0,0.0,0.1,0.4,9125,33054,0,9,54,162
E14001031,WEST DORSET,53076,53010,91.9,10.4,8.4,6.7,6.7,0.3,1.2,2.4,7.9,0.7,97.8,48797,5524,4466,135,638,1286,4213,3577,3577,385,51928,1503,83.5,8.4,2.8,0.3,0.9,1.2,5.5,44331,4466,135,503,648,2927
E14001032,WEST HAM,71477,71261,98.3,90.9,86.1,19.4,19.4,0.0,0.0,0.3,1.4,0.3,98.4,70292,64975,61569,1,14,221,969,13882,13882,216,70303,0,12.2,86.1,0.0,0.0,0.0,0.3,1.0,8723,61569,1,13,207,748
E14001033,WEST LANCASHIRE,44321,44272,94.6,42.8,32.2,25.6,25.7,0.2,0.9,1.4,5.3,0.2,98.9,41917,18984,14284,102,389,623,2355,11353,11372,77,43844,1728,62.3,32.2,3.9,0.2,0.6,0.5,3.9,27633,14284,102,287,234,1732
E14001034,WEST SUFFOLK,55700,55645,95.0,29.3,25.8,9.8,9.8,0.2,0.5,0.8,4.9,0.4,99.3,52917,16344,14359,96,279,457,2728,5434,5434,220,55285,119,69.2,25.8,0.2,0.2,0.3,0.3,4.1,38558,14359,96,183,178,2271
E14001035,WEST WORCESTERSHIRE,47493,47336,89.9,19.4,13.8,10.2,10.2,0.5,2.0,3.7,9.8,1.0,97.4,42702,9233,6549,229,973,1779,4634,4829,4829,471,46270,2356,76.1,13.8,5.0,0.5,1.6,1.7,6.0,36153,6549,229,744,806,2855
E14001036,WESTMINSTER NORTH,62952,62854,97.9,58.0,56.5,51.0,51.0,0.0,0.0,0.0,2.0,0.2,97.9,61610,36521,35583,0,0,2,1244,32092,32092,98,61618,0,41.3,56.5,0.0,0.0,0.0,0.0,2.0,26027,35583,0,0,2,1242
E14001037,WESTMORLAND AND LONSDALE,49647,49556,93.2,15.4,13.6,12.2,12.2,0.4,1.0,1.9,6.7,0.9,98.4,46252,7663,6732,204,482,962,3304,6062,6062,457,48831,22158,79.6,13.6,44.6,0.4,0.6,1.0,4.7,39520,6732,204,278,480,2342
E14001038,WESTON-SUPER-MARE,55221,54347,90.5,43.0,34.1,25.9,25.9,0.1,0.4,1.5,7.9,1.7,95.6,49996,23762,18815,57,233,831,4351,14323,14323,913,52784,0,56.5,34.1,0.0,0.1,0.3,1.1,6.4,31181,18815,57,176,598,3520
E14001039,WIGAN,50448,50425,97.9,85.9,83.9,1.2,1.2,0.0,0.1,0.4,2.0,0.1,99.3,49410,43332,42341,10,73,209,1015,590,590,41,50072,0,14.0,83.9,0.0,0.0,0.1,0.3,1.6,7069,42341,10,63,136,806
E14001040,WIMBLEDON,45381,45361,98.4,87.7,86.5,45.7,45.7,0.0,0.0,0.3,1.6,0.0,98.4,44645,39782,39268,1,11,129,716,20719,20719,18,44666,0,11.8,86.5,0.0,0.0,0.0,0.3,1.3,5377,39268,1,10,118,587
E14001041,WINCHESTER,45062,45014,95.0,54.5,43.3,3.2,3.9,0.1,0.6,1.2,4.8,0.2,98.7,42829,24567,19518,55,276,519,2185,1434,1762,109,44455,0,51.7,43.3,0.0,0.1,0.5,0.5,3.7,23311,19518,55,221,243,1666
E14001042,WINDSOR,48629,48561,93.7,54.7,50.8,4.9,15.5,0.2,0.4,0.9,6.1,0.3,97.6,45585,26623,24718,91,188,431,2976,2404,7524,129,47479,0,42.9,50.8,0.0,0.2,0.2,0.5,5.2,20867,24718,91,97,243,2545
E14001043,WIRRAL SOUTH,34588,34571,96.5,59.4,59.4,1.9,1.9,0.1,0.2,0.4,3.5,0.0,99.7,33365,20537,20534,25,58,141,1206,641,642,16,34489,0,37.1,59.4,0.0,0.1,0.1,0.2,3.1,12831,20534,25,33,83,1065
E14001044,WIRRAL WEST,32972,32961,94.5,33.1,33.1,21.5,21.5,0.0,0.2,0.3,5.5,0.0,98.9,31160,10926,10925,5,61,113,1801,7101,7101,13,32615,0,61.4,33.1,0.0,0.0,0.2,0.2,5.1,20235,10925,5,56,52,1688
E14001045,WITHAM,43013,42871,92.2,14.6,14.6,8.6,8.6,0.3,1.2,2.2,7.5,0.9,96.3,39646,6283,6283,143,523,958,3225,3679,3679,406,41431,0,77.6,14.6,0.0,0.3,0.9,1.0,5.3,33363,6283,143,380,435,2267
E14001046,WITNEY,52249,52148,97.8,63.6,56.6,24.9,24.9,0.1,0.3,0.6,2.0,0.3,99.1,51111,33246,29574,42,131,330,1037,13010,13010,180,51792,0,41.2,56.6,0.0,0.1,0.2,0.4,1.4,21537,29574,42,89,199,707
E14001047,WOKING,47688,47597,97.5,81.8,78.9,3.5,3.5,0.0,0.3,0.4,2.3,0.2,99.2,46514,39020,37631,1,145,172,1083,1650,1650,108,47309,0,18.6,78.9,0.0,0.0,0.3,0.1,1.9,8883,37631,1,144,27,911
E14001048,WOKINGHAM,51595,50820,94.6,69.7,65.4,16.8,62.5,0.1,0.2,0.6,3.9,1.5,95.8,48803,35937,33736,27,114,290,2017,8645,32248,785,49438,0,29.2,65.4,0.0,0.1,0.2,0.3,3.3,15067,33736,27,87,176,1727
E14001049,WOLVERHAMPTON NORTH EAST,41149,41082,98.9,91.6,90.5,2.5,3.0,0.0,0.0,0.1,1.0,0.2,99.0,40680,37673,37247,1,1,44,402,1012,1231,66,40738,98,8.3,90.5,0.2,0.0,0.0,0.1,0.9,3433,37247,1,0,43,358
E14001050,WOLVERHAMPTON SOUTH EAST,42262,42121,99.1,89.2,87.9,1.8,1.8,0.0,0.0,0.0,0.6,0.3,99.5,41861,37710,37147,1,3,21,260,744,752,139,42042,492,11.2,87.9,1.2,0.0,0.0,0.0,0.6,4714,37147,1,2,18,239
E14001051,WOLVERHAMPTON SOUTH WEST,39987,39935,97.5,91.9,89.7,1.1,1.1,0.0,0.0,0.0,2.3,0.1,97.7,38996,36760,35852,0,0,12,939,432,434,51,39063,5347,7.9,89.7,13.4,0.0,0.0,0.0,2.3,3144,35852,0,0,12,927
E14001052,WORCESTER,48752,48681,98.9,22.1,11.0,2.4,2.4,0.0,0.0,0.0,1.0,0.1,99.5,48205,10768,5379,0,1,8,476,1192,1192,71,48509,49,87.8,11.0,0.1,0.0,0.0,0.0,1.0,42826,5379,0,1,7,468
E14001053,WORKINGTON,41093,40996,93.7,2.6,2.6,2.6,2.6,0.9,1.5,2.3,6.0,0.8,99.0,38519,1088,1088,371,634,951,2477,1088,1088,340,40685,38,91.1,2.6,0.1,0.9,0.6,0.8,3.7,37431,1088,371,263,317,1526
E14001054,WORSLEY AND ECCLES SOUTH,49802,49774,98.3,94.2,94.2,74.1,94.2,0.0,0.2,0.6,1.6,0.1,98.6,48976,46920,46920,12,119,311,798,36885,46918,35,49090,0,4.1,94.2,0.0,0.0,0.2,0.4,1.0,2056,46920,12,107,192,487
E14001055,WORTHING WEST,49826,49796,98.8,74.4,69.2,22.9,22.9,0.0,0.0,0.0,1.1,0.1,99.8,49252,37086,34471,3,4,10,544,11424,11424,30,49742,0,29.7,69.2,0.0,0.0,0.0,0.0,1.1,14781,34471,3,1,6,534
E14001056,WYCOMBE,47499,47402,97.0,50.0,37.8,1.7,27.1,0.0,0.2,0.3,2.7,0.2,99.5,46097,23764,17948,12,72,151,1305,818,12881,115,47246,0,59.3,37.8,0.0,0.0,0.1,0.2,2.4,28149,17948,12,60,79,1154
E14001057,WYRE AND PRESTON NORTH,44786,44665,94.1,33.8,32.7,10.7,10.7,0.2,0.4,1.0,5.6,0.3,98.4,42162,15146,14625,73,158,430,2503,4804,4804,142,44062,5164,61.5,32.7,11.5,0.2,0.2,0.6,4.6,27537,14625,73,85,272,2073
E14001058,WYRE FOREST,48237,48173,96.8,47.9,47.8,2.0,47.8,0.2,0.5,0.8,3.1,0.4,99.5,46680,23125,23035,84,218,389,1493,961,23034,183,48001,1675,49.0,47.8,3.5,0.2,0.3,0.4,2.3,23645,23035,84,134,171,1104
E14001059,WYTHENSHAWE AND SALE EAST,50509,50442,97.3,90.6,89.8,35.2,88.5,0.0,0.3,1.4,2.6,0.1,97.8,49123,45756,45343,12,165,695,1319,17780,44685,68,49422,0,7.5,89.8,0.0,0.0,0.3,1.0,1.2,3780,45343,12,153,530,624
E14001060,YEOVIL,55471,55145,90.7,2.2,2.2,2.2,2.2,0.4,1.9,2.9,8.7,0.9,97.6,50302,1206,1206,205,1031,1614,4843,1206,1206,510,54130,74,88.5,2.2,0.1,0.4,1.5,1.1,5.8,49096,1206,205,826,583,3229
E14001061,YORK CENTRAL,52090,51878,93.8,84.0,79.6,54.3,54.3,0.0,0.1,0.6,5.8,0.4,94.0,48872,43771,41442,0,35,330,3006,28297,28297,212,48964,1649,14.3,79.6,3.2,0.0,0.1,0.6,5.1,7430,41442,0,35,295,2676
E14001062,YORK OUTER,43859,43796,94.5,65.3,62.7,55.3,55.3,0.1,0.4,1.0,5.4,0.2,98.3,41441,28644,27510,39,174,444,2355,24252,24252,84,43121,1873,31.8,62.7,4.3,0.1,0.3,0.6,4.4,13931,27510,39,135,270,1911
N06000001,BELFAST EAST,47242,47084,97.3,90.9,90.7,72.7,72.7,0.0,0.2,0.5,2.4,0.3,97.9,45968,42936,42825,7,111,237,1116,34362,34362,163,46235,0,6.7,90.7,0.0,0.0,0.2,0.3,1.9,3143,42825,7,104,126,879
N06000002,BELFAST NORTH,52371,52175,98.1,93.0,92.8,74.7,74.7,0.0,0.0,0.6,1.5,0.4,98.3,51381,48698,48598,15,23,340,794,39147,39147,198,51481,0,5.3,92.8,0.0,0.0,0.0,0.6,0.9,2783,48598,15,8,317,454
N06000003,BELFAST SOUTH,56943,56667,97.2,89.7,89.0,67.8,67.8,0.0,0.1,0.3,2.3,0.5,97.3,55329,51101,50669,4,35,180,1338,38612,38612,276,55396,0,8.2,89.0,0.0,0.0,0.1,0.3,2.0,4660,50669,4,31,145,1158
N06000004,BELFAST WEST,41543,41365,98.8,91.2,91.0,66.6,66.6,0.0,0.1,0.1,0.8,0.4,99.1,41050,37884,37821,7,26,44,315,27665,27665,178,41161,0,7.8,91.0,0.0,0.0,0.0,0.0,0.7,3229,37821,7,19,18,271
N06000005,EAST ANTRIM,41159,40784,92.2,60.4,60.1,57.8,57.8,1.8,2.6,3.3,6.8,1.7,98.1,37967,24846,24718,750,1064,1359,2817,23795,23795,698,40389,0,32.2,60.1,0.0,1.8,0.8,0.7,3.5,13249,24718,750,314,295,1458
N06000006,EAST LONDONDERRY,46826,45848,86.0,47.9,47.9,47.9,47.9,2.4,4.3,5.7,11.9,4.0,97.3,40264,22443,22426,1135,1991,2676,5584,22438,22438,1872,45567,0,38.1,47.9,0.0,2.4,1.8,1.5,6.2,17838,22426,1135,856,685,2908
N06000007,FERMANAGH AND SOUTH TYRONE,45748,45153,71.1,23.1,23.1,23.1,23.1,6.9,11.7,16.6,27.6,4.1,97.7,32510,10569,10568,3175,5360,7604,12643,10568,10568,1883,44700,19949,48.0,23.1,43.6,6.9,4.8,4.9,11.0,21942,10568,3175,2185,2244,5039
N06000008,FOYLE,43482,43406,97.3,88.0,87.9,59.0,59.0,0.4,0.6,0.8,2.5,0.3,99.2,42305,38246,38223,166,244,360,1101,25673,25673,109,43152,0,9.4,87.9,0.0,0.4,0.2,0.3,1.7,4082,38223,166,78,116,741
N06000009,LAGAN VALLEY,45861,45460,91.3,63.1,62.9,49.8,49.8,0.6,1.8,2.8,7.8,1.5,98.8,41867,28922,28865,281,847,1290,3593,22855,22855,698,45297,0,28.4,62.9,0.0,0.6,1.2,1.0,5.0,13002,28865,281,566,443,2303
N06000010,MID ULSTER,38497,38043,77.2,31.9,31.9,31.9,31.9,3.2,6.4,10.0,21.7,5.2,97.3,29704,12282,12282,1247,2450,3856,8339,12282,12282,1987,37440,0,45.3,31.9,0.0,3.2,3.1,3.7,11.6,17422,12282,1247,1203,1406,4483
N06000011,NEWRY AND ARMAGH,46164,45489,82.4,37.2,37.2,37.2,37.2,2.8,5.2,7.6,16.1,4.4,97.7,38035,17193,17178,1313,2391,3502,7454,17193,17193,2030,45082,1578,45.2,37.2,3.4,2.8,2.3,2.4,8.6,20857,17178,1313,1078,1111,3952
N06000012,NORTH ANTRIM,48068,47342,84.2,44.3,44.1,44.3,44.3,2.5,5.1,7.3,14.2,3.4,97.4,40496,21288,21208,1213,2431,3501,6846,21286,21286,1611,46803,0,40.1,44.1,0.0,2.5,2.5,2.2,7.0,19288,21208,1213,1218,1070,3345
N06000013,NORTH DOWN,42377,42276,98.1,81.1,80.8,77.3,77.3,0.1,0.3,0.5,1.6,0.3,99.7,41589,34366,34254,49,106,194,687,32749,32749,141,42257,0,17.3,80.8,0.0,0.1,0.1,0.2,1.2,7335,34254,49,57,88,493
N06000014,SOUTH ANTRIM,42364,41865,86.8,62.6,62.3,55.3,55.3,2.4,4.5,5.9,12.0,2.5,97.5,36774,26538,26389,1003,1902,2485,5091,23436,23436,1059,41320,0,24.5,62.3,0.0,2.4,2.1,1.4,6.2,10385,26389,1003,899,583,2606
N06000015,SOUTH DOWN,44240,43423,79.4,27.8,27.8,27.8,27.8,3.7,6.9,10.0,18.8,4.6,96.0,35114,12295,12295,1644,3046,4402,8309,12295,12295,2053,42451,864,51.6,27.8,2.0,3.7,3.2,3.1,8.8,22819,12295,1644,1402,1356,3907
N06000016,STRANGFORD,40013,39779,88.6,52.7,52.6,52.7,52.7,1.2,2.8,5.1,10.8,1.8,99.1,35443,21087,21041,478,1135,2042,4336,21086,21086,715,39660,0,36.0,52.6,0.0,1.2,1.6,2.3,5.7,14402,21041,478,657,907,2294
N06000017,UPPER BANN,52728,52495,94.5,73.9,72.7,73.9,73.9,0.4,0.8,1.4,5.1,0.7,99.3,49820,38990,38333,204,411,715,2675,38989,38989,373,52356,0,21.8,72.7,0.0,0.4,0.4,0.6,3.7,11487,38333,204,207,304,1960
N06000018,WEST TYRONE,38398,37697,74.6,39.2,39.2,39.2,39.2,7.5,11.8,14.8,23.6,7.3,97.1,28652,15054,15049,2861,4529,5685,9045,15053,15053,2785,37291,2510,35.4,39.2,6.5,7.5,4.3,3.0,8.8,13603,15049,2861,1668,1156,3360
S14000001,ABERDEEN NORTH,56860,56815,95.1,43.8,31.8,20.5,20.5,0.0,0.0,0.7,4.8,0.1,96.6,54059,24899,18065,0,7,387,2756,11629,11629,51,54940,0,63.3,31.8,0.0,0.0,0.0,0.7,4.2,35994,18065,0,7,380,2369
S14000002,ABERDEEN SOUTH,53209,53066,95.3,65.3,61.6,58.3,58.3,0.0,0.2,0.4,4.5,0.4,97.6,50696,34750,32775,22,99,191,2370,31026,31026,203,51913,0,33.7,61.6,0.0,0.0,0.1,0.2,4.1,17921,32775,22,77,92,2179
S14000003,AIRDRIE AND SHOTTS,41278,41252,97.1,63.8,63.6,4.3,63.7,0.1,0.3,0.7,2.8,0.3,99.3,40085,26341,26272,29,137,309,1167,1765,26277,122,40990,0,33.5,63.6,0.0,0.1,0.3,0.4,2.1,13813,26272,29,108,172,858
S14000004,ANGUS,46577,46161,85.8,1.6,1.6,1.6,1.6,1.5,4.3,7.6,13.3,2.9,94.6,39972,753,753,714,1982,3547,6189,753,753,1356,44084,0,84.2,1.6,0.0,1.5,2.7,3.4,5.7,39219,753,714,1268,1565,2642
S14000005,ARGYLL AND BUTE,56475,54908,77.7,1.6,1.6,1.6,1.6,3.2,6.1,10.6,19.5,8.0,88.1,43886,885,885,1799,3419,5969,11022,884,885,4527,49764,0,76.1,1.6,0.0,3.2,2.9,4.5,8.9,43001,885,1799,1620,2550,5053
S14000006,"AYR, CARRICK AND CUMNOCK",48140,48035,93.6,39.8,37.5,1.2,1.2,0.6,1.6,2.9,6.2,1.1,98.1,45066,19157,18037,271,760,1374,2969,581,581,542,47224,0,56.1,37.5,0.0,0.6,1.0,1.3,3.3,27029,18037,271,489,614,1595
S14000007,BANFF AND BUCHAN,46717,46408,84.6,3.5,3.5,3.5,3.5,2.3,5.3,8.5,14.7,2.9,94.9,39526,1612,1612,1085,2470,3989,6882,1612,1612,1341,44325,0,81.2,3.5,0.0,2.3,3.0,3.3,6.2,37914,1612,1085,1385,1519,2893
S14000008,"BERWICKSHIRE, ROXBURGH AND SELKIRK",51661,51143,85.9,15.8,12.2,9.7,9.7,1.8,4.2,7.2,13.1,3.2,95.1,44383,8146,6309,909,2160,3703,6760,5011,5011,1641,49146,8971,73.7,12.2,17.4,1.8,2.4,3.0,5.9,38074,6309,909,1251,1543,3057
S14000009,"CAITHNESS, SUTHERLAND AND EASTER ROSS",29381,28906,76.9,1.4,1.4,1.4,1.4,2.5,5.5,9.9,21.4,4.4,92.7,22604,421,421,736,1608,2914,6302,421,421,1286,27232,2945,75.5,1.4,10.0,2.5,3.0,4.4,11.5,22183,421,736,872,1306,3388
S14000010,CENTRAL AYRSHIRE,44805,44792,95.2,68.4,68.3,1.8,1.8,0.2,0.7,1.8,4.7,0.4,99.0,42676,30633,30609,98,310,814,2116,807,807,169,44343,0,26.9,68.3,0.0,0.2,0.5,1.1,2.9,12067,30609,98,212,504,1302
S14000011,"COATBRIDGE, CHRYSTON AND BELLSHILL",46271,46201,98.2,84.8,82.7,19.9,82.5,0.1,0.6,0.8,1.7,0.2,98.6,45428,39242,38271,41,271,367,773,9224,38194,82,45637,0,15.5,82.7,0.0,0.1,0.5,0.2,0.9,7157,38271,41,230,96,406
S14000012,"CUMBERNAULD, KILSYTH AND KIRKINTILLOCH EAST",42669,42625,95.8,65.8,63.9,12.5,63.4,0.1,0.4,0.9,4.1,0.2,99.0,40889,28075,27263,41,159,382,1736,5348,27043,103,42240,0,31.9,63.9,0.0,0.1,0.3,0.5,3.2,13626,27263,41,118,223,1354
S14000013,DUMFRIES AND GALLOWAY,54159,53529,85.8,6.6,6.6,6.6,6.6,1.6,3.7,6.3,13.0,3.3,96.1,46478,3583,3583,887,2025,3416,7051,3583,3583,1802,52043,0,79.2,6.6,0.0,1.6,2.1,2.6,6.7,42895,3583,887,1138,1391,3635
S14000014,"DUMFRIESSHIRE, CLYDESDALE AND TWEEDDALE",45193,44744,82.4,6.3,6.3,6.3,6.3,2.0,4.7,8.4,16.6,4.0,95.1,37244,2838,2837,884,2115,3818,7500,2837,2837,1798,42987,0,76.1,6.3,0.0,2.0,2.7,3.8,8.1,34407,2837,884,1231,1703,3682
S14000015,DUNDEE EAST,44076,44019,96.3,79.6,78.2,1.2,1.2,0.2,0.5,1.3,3.6,0.2,98.6,42434,35106,34468,75,210,569,1585,540,540,109,43472,0,18.1,78.2,0.0,0.2,0.3,0.8,2.3,7966,34468,75,135,359,1016
S14000016,DUNDEE WEST,49601,49546,97.8,84.8,82.0,1.2,1.2,0.1,0.2,0.7,2.1,0.2,98.8,48491,42050,40683,68,116,326,1055,612,612,75,48993,0,15.7,82.0,0.0,0.1,0.1,0.4,1.5,7808,40683,68,48,210,729
S14000017,DUNFERMLINE AND WEST FIFE,50559,50460,97.0,55.6,54.1,54.5,54.5,0.3,0.7,1.1,2.8,0.4,99.5,49033,28098,27365,136,375,568,1427,27566,27566,207,50299,0,42.9,54.1,0.0,0.3,0.5,0.4,1.7,21668,27365,136,239,193,859
S14000018,EAST DUNBARTONSHIRE,37549,37511,97.6,85.5,84.3,20.6,83.3,0.0,0.1,0.3,2.3,0.1,98.6,36650,32111,31646,6,33,114,861,7734,31274,47,37034,0,13.3,84.3,0.0,0.0,0.1,0.2,2.0,5004,31646,6,27,81,747
S14000019,"EAST KILBRIDE, STRATHAVEN AND LESMAHAGOW",50046,49906,95.4,62.1,62.0,4.3,62.0,0.5,1.1,2.3,4.4,0.5,98.0,47720,31075,31020,237,544,1170,2186,2152,31020,266,49070,0,33.4,62.0,0.0,0.5,0.6,1.3,2.0,16700,31020,237,307,626,1016
S14000020,EAST LOTHIAN,48818,48698,92.5,24.4,23.7,24.4,24.4,0.4,1.4,2.5,7.3,0.4,97.6,45147,11926,11593,196,698,1198,3551,11925,11926,211,47656,20232,68.7,23.7,41.4,0.4,1.0,1.0,4.8,33554,11593,196,502,500,2353
S14000021,EAST RENFREWSHIRE,41004,40988,95.9,70.6,69.9,7.1,69.8,0.1,0.2,0.5,4.1,0.1,98.9,39325,28937,28652,35,95,224,1663,2892,28621,44,40551,0,26.0,69.9,0.0,0.1,0.1,0.3,3.5,10673,28652,35,60,129,1439
S14000022,EDINBURGH EAST,55589,55574,96.6,82.2,81.4,52.9,80.5,0.0,0.1,0.2,3.3,0.0,96.7,53725,45713,45230,1,36,136,1849,29405,44741,15,53778,0,15.3,81.4,0.0,0.0,0.1,0.2,3.1,8495,45230,1,35,100,1713
S14000023,EDINBURGH NORTH AND LEITH,68087,68042,97.9,84.9,82.4,20.9,80.2,0.0,0.1,0.2,2.0,0.1,97.9,66660,57786,56137,0,54,121,1382,14245,54585,44,66680,0,15.5,82.4,0.0,0.0,0.1,0.1,1.9,10523,56137,0,54,67,1261
S14000024,EDINBURGH SOUTH,41777,41765,98.7,90.4,88.8,34.2,87.9,0.0,0.1,0.1,1.2,0.0,98.9,41249,37759,37116,1,23,32,516,14280,36715,12,41321,0,9.9,88.8,0.0,0.0,0.1,0.0,1.2,4133,37116,1,22,9,484
S14000025,EDINBURGH SOUTH WEST,53920,53905,98.0,93.6,91.0,42.1,88.5,0.1,0.2,0.4,1.9,0.1,98.5,52857,50471,49043,56,83,189,1048,22713,47719,34,53099,0,7.1,91.0,0.0,0.1,0.1,0.2,1.6,3814,49043,56,27,106,859
S14000026,EDINBURGH WEST,45719,45710,97.2,81.2,79.6,51.5,78.9,0.1,0.6,1.0,2.8,0.1,98.7,44449,37106,36394,49,278,467,1261,23548,36085,38,45140,0,17.6,79.6,0.0,0.1,0.5,0.4,1.7,8055,36394,49,229,189,794
S14000027,NA H-EILEANAN AN IAR,16592,15186,75.3,3.7,3.7,3.7,3.7,2.8,4.2,5.5,16.3,10.8,88.3,12487,620,620,460,696,912,2699,620,620,1789,14645,0,71.5,3.7,0.0,2.8,1.4,1.3,10.8,11867,620,460,236,216,1787
S14000028,FALKIRK,51071,51018,96.8,83.2,83.0,7.2,82.9,0.1,0.4,0.7,3.1,0.3,98.7,49458,42478,42399,51,210,383,1560,3698,42342,128,50383,0,13.8,83.0,0.0,0.1,0.3,0.3,2.3,7059,42399,51,159,173,1177
S14000029,GLASGOW CENTRAL,63787,63686,91.1,55.7,49.1,18.1,44.7,0.0,0.0,0.2,8.7,0.2,91.5,58124,35506,31301,0,6,116,5562,11564,28502,101,58346,0,42.1,49.1,0.0,0.0,0.0,0.2,8.5,26823,31301,0,6,110,5446
S14000030,GLASGOW EAST,48040,47925,98.3,64.7,61.6,20.9,57.0,0.0,0.0,0.7,1.5,0.2,98.6,47210,31077,29572,0,13,339,715,10036,27394,117,47390,0,36.7,61.6,0.0,0.0,0.0,0.7,0.8,17638,29572,0,13,326,376
S14000031,GLASGOW NORTH,42639,42410,98.5,82.7,75.0,4.9,67.8,0.0,0.1,0.2,1.0,0.5,98.7,41987,35247,31980,14,28,71,423,2072,28905,228,42100,0,23.5,75.0,0.0,0.0,0.0,0.1,0.8,10007,31980,14,14,43,352
S14000032,GLASGOW NORTH EAST,45357,45312,98.8,77.6,71.2,12.1,64.4,0.0,0.0,0.1,1.1,0.1,99.4,44813,35184,32291,0,0,58,499,5481,29226,45,45095,0,27.6,71.2,0.0,0.0,0.0,0.1,1.0,12522,32291,0,0,58,441
S14000033,GLASGOW NORTH WEST,45649,45620,99.5,82.3,75.3,3.0,67.3,0.0,0.0,0.1,0.4,0.1,99.7,45435,37584,34375,4,6,23,185,1366,30730,29,45522,0,24.2,75.3,0.0,0.0,0.0,0.0,0.4,11060,34375,4,2,17,162
S14000034,GLASGOW SOUTH,45955,45931,97.6,73.1,65.8,4.6,57.5,0.0,0.0,0.3,2.3,0.1,98.2,44869,33582,30237,2,10,121,1062,2135,26446,27,45143,0,31.8,65.8,0.0,0.0,0.0,0.2,2.0,14632,30237,2,8,111,941
S14000035,GLASGOW SOUTH WEST,44050,44035,99.0,56.4,54.3,38.0,52.3,0.1,0.3,0.3,1.0,0.0,99.5,43591,24864,23916,43,127,146,444,16749,23039,15,43826,0,44.7,54.3,0.0,0.1,0.2,0.0,0.7,19675,23916,43,84,19,298
S14000036,GLENROTHES,45234,45186,96.3,71.3,71.1,4.0,4.0,0.1,0.2,0.9,3.6,0.2,99.2,43541,32244,32158,52,105,406,1645,1829,1829,83,44892,0,25.2,71.1,0.0,0.1,0.1,0.7,2.7,11383,32158,52,53,301,1239
S14000037,GORDON,50250,50094,84.9,13.7,12.6,12.2,12.2,1.9,4.2,7.0,14.8,2.5,95.6,42656,6880,6352,936,2086,3525,7438,6127,6127,1267,48031,0,72.2,12.6,0.0,1.9,2.3,2.9,7.8,36304,6352,936,1150,1439,3913
S14000038,INVERCLYDE,42012,41964,97.0,73.1,72.8,9.8,9.8,0.1,0.3,0.6,2.9,0.2,98.6,40746,30728,30583,41,122,256,1218,4098,4098,97,41408,0,24.2,72.8,0.0,0.1,0.2,0.3,2.3,10163,30583,41,81,134,962
S14000039,"INVERNESS, NAIRN, BADENOCH AND STRATHSPEY",52779,52320,86.8,14.8,14.8,14.8,14.8,1.3,2.5,4.2,12.3,2.5,96.4,45826,7834,7834,677,1332,2199,6494,7834,7834,1324,50868,264,72.0,14.8,0.5,1.3,1.2,1.6,8.1,37992,7834,677,655,867,4295
S14000040,KILMARNOCK AND LOUDOUN,47852,47789,95.9,54.3,54.3,43.3,43.3,0.5,1.1,1.7,4.0,0.3,98.7,45872,26000,25999,258,507,826,1917,20737,20737,142,47227,0,41.5,54.3,0.0,0.5,0.5,0.7,2.3,19873,25999,258,249,319,1091
S14000041,KIRKCALDY AND COWDENBEATH,51516,51450,97.6,62.5,62.3,21.0,21.0,0.1,0.2,0.3,2.2,0.2,99.1,50295,32180,32116,36,91,165,1155,10822,10822,86,51040,0,35.3,62.3,0.0,0.1,0.1,0.1,1.9,18179,32116,36,55,74,990
S14000042,LANARK AND HAMILTON EAST,51647,51307,94.2,56.3,56.0,14.3,56.2,0.3,1.1,2.3,5.1,0.8,98.3,48648,29053,28944,179,590,1186,2659,7362,29003,418,50763,0,38.2,56.0,0.0,0.3,0.8,1.2,2.9,19704,28944,179,411,596,1473
S14000043,LINLITHGOW AND EAST FALKIRK,56540,56483,95.9,68.0,67.5,26.0,67.3,0.1,0.4,1.0,4.0,0.3,99.0,54234,38454,38138,51,228,545,2249,14693,38069,159,55994,0,28.5,67.5,0.0,0.1,0.3,0.6,3.0,16096,38138,51,177,317,1704
S14000044,LIVINGSTON,52388,52336,97.8,76.1,74.1,20.5,72.9,0.2,0.5,0.8,2.1,0.2,99.2,51226,39860,38838,101,237,419,1110,10751,38207,120,51979,0,23.6,74.1,0.0,0.2,0.3,0.3,1.3,12388,38838,101,136,182,691
S14000045,MIDLOTHIAN,40548,40324,93.4,38.3,38.0,38.3,38.3,0.7,1.6,2.7,6.0,0.8,98.0,37883,15520,15402,267,631,1075,2441,15518,15519,342,39722,2121,55.4,38.0,5.2,0.7,0.9,1.1,3.4,22481,15402,267,364,444,1366
S14000046,MORAY,49316,48924,84.3,9.5,9.5,9.5,9.5,1.6,4.5,7.0,14.9,3.4,95.4,41572,4697,4697,797,2198,3457,7352,4697,4697,1655,47049,0,74.8,9.5,0.0,1.6,2.8,2.6,7.9,36875,4697,797,1401,1259,3895
S14000047,MOTHERWELL AND WISHAW,46397,46371,98.9,83.2,82.9,1.4,82.7,0.0,0.0,0.2,1.1,0.1,99.4,45868,38612,38448,0,14,113,503,650,38374,29,46122,0,16.0,82.9,0.0,0.0,0.0,0.2,0.8,7420,38448,0,14,99,390
S14000048,NORTH AYRSHIRE AND ARRAN,50349,50270,93.0,12.6,12.6,12.6,12.6,0.5,1.1,2.0,6.8,0.5,99.0,46832,6365,6359,269,529,1003,3438,6365,6365,256,49865,0,80.4,12.6,0.0,0.5,0.5,0.9,4.8,40473,6359,269,260,474,2435
S14000049,NORTH EAST FIFE,42776,42621,90.7,14.4,13.6,8.1,8.1,0.5,1.8,3.6,8.9,0.8,97.7,38818,6149,5801,235,791,1535,3803,3478,3478,353,41802,0,77.2,13.6,0.0,0.5,1.3,1.7,5.3,33017,5801,235,556,744,2268
S14000050,OCHIL AND SOUTH PERTHSHIRE,51487,51156,87.8,13.2,7.3,4.7,4.7,1.2,3.0,5.0,11.5,1.6,97.2,45229,6804,3733,624,1549,2587,5927,2444,2444,821,50045,0,80.6,7.3,0.0,1.2,1.8,2.0,6.5,41496,3733,624,925,1038,3340
S14000051,ORKNEY AND SHETLAND,24067,23173,67.0,1.4,1.4,1.4,1.4,3.6,8.4,18.8,29.3,6.8,79.9,16119,346,346,864,2028,4529,7054,346,346,1645,19236,0,65.5,1.4,0.0,3.6,4.8,10.4,10.5,15773,346,864,1164,2501,2525
S14000052,PAISLEY AND RENFREWSHIRE NORTH,47285,47254,96.1,76.0,75.8,18.9,51.9,0.1,0.3,0.5,3.8,0.1,98.1,45439,35919,35851,41,124,260,1815,8939,24525,46,46377,0,20.3,75.8,0.0,0.1,0.2,0.3,3.3,9588,35851,41,83,136,1555
S14000053,PAISLEY AND RENFREWSHIRE SOUTH,47392,47371,97.1,71.5,71.4,3.7,36.7,0.1,0.3,0.6,2.8,0.1,98.6,46036,33870,33856,64,144,303,1335,1732,17393,40,46733,0,25.7,71.4,0.0,0.1,0.2,0.3,2.2,12180,33856,64,80,159,1032
S14000054,PERTH AND NORTH PERTHSHIRE,52888,52538,86.9,48.7,47.3,3.5,3.5,1.3,3.3,6.0,12.4,2.4,95.2,45958,25774,25039,700,1756,3154,6580,1864,1864,1261,50342,0,39.6,47.3,0.0,1.3,2.0,2.6,6.5,20919,25039,700,1056,1398,3426
S14000055,"ROSS, SKYE AND LOCHABER",33148,31927,75.7,3.8,3.8,3.8,3.8,3.4,6.1,10.8,20.7,5.3,90.0,25078,1276,1276,1115,2026,3566,6849,1276,1276,1756,29843,1863,71.8,3.8,5.6,3.4,2.7,4.6,9.9,23802,1276,1115,911,1540,3283
S14000056,RUTHERGLEN AND HAMILTON WEST,52289,52140,98.1,85.9,84.7,14.2,83.4,0.1,0.1,0.2,1.6,0.3,99.2,51285,44898,44266,27,54,108,855,7400,43634,157,51892,0,13.4,84.7,0.0,0.1,0.1,0.1,1.4,7019,44266,27,27,54,747
S14000057,STIRLING,46393,45705,88.3,52.1,49.9,48.8,48.8,1.4,3.1,4.9,10.2,3.4,95.7,40967,24167,23172,648,1437,2277,4738,22638,22654,1575,44396,0,38.4,49.9,0.0,1.4,1.7,1.8,5.3,17795,23172,648,789,840,2461
S14000058,WEST ABERDEENSHIRE AND KINCARDINE,45205,44741,81.6,6.1,5.6,5.3,5.3,2.8,5.9,9.5,17.4,4.4,94.1,36893,2775,2529,1246,2645,4305,7848,2389,2389,1976,42556,0,76.0,5.6,0.0,2.8,3.1,3.7,7.8,34364,2529,1246,1399,1660,3543
S14000059,WEST DUNBARTONSHIRE,47053,47033,98.4,89.6,88.2,0.6,86.7,0.1,0.2,0.5,1.6,0.1,99.0,46284,42173,41486,24,95,228,749,300,40818,30,46602,0,10.2,88.2,0.0,0.1,0.2,0.3,1.1,4798,41486,24,71,133,521
W07000041,YNYS MÔN,37150,36840,88.3,16.1,16.1,16.1,16.1,0.8,2.3,4.0,10.8,2.1,95.2,32810,5982,5981,312,844,1472,4030,5981,5981,765,35378,9441,72.2,16.1,25.4,0.8,1.4,1.7,6.9,26829,5981,312,532,628,2558
W07000042,DELYN,34140,34065,92.4,21.1,15.6,12.7,12.7,0.5,1.4,3.4,7.4,0.6,96.9,31553,7192,5329,159,481,1168,2512,4336,4336,218,33069,12275,76.8,15.6,36.0,0.5,0.9,2.0,3.9,26224,5329,159,322,687,1344
W07000043,ALYN AND DEESIDE,39811,39751,95.0,39.2,29.3,23.3,23.3,0.4,1.0,1.9,4.9,0.4,98.0,37814,15590,11661,149,394,751,1937,9277,9277,174,39022,17075,65.7,29.3,42.9,0.4,0.6,0.9,3.0,26153,11661,149,245,357,1186
W07000044,WREXHAM,35251,34722,95.7,54.8,54.6,54.8,54.8,0.0,0.3,0.7,2.8,1.5,97.0,33749,19314,19252,7,97,232,973,19313,19313,543,34189,15462,41.1,54.6,43.9,0.0,0.3,0.4,2.1,14497,19252,7,90,135,741
W07000045,LLANELLI,40665,40572,94.7,24.5,24.5,24.5,24.5,0.6,1.3,2.2,5.1,0.4,98.1,38496,9959,9959,253,518,903,2076,9955,9955,168,39898,3378,70.2,24.5,8.3,0.6,0.7,0.9,2.9,28537,9959,253,265,385,1173
W07000046,GOWER,38369,38292,94.4,57.6,53.5,21.8,21.8,0.3,0.7,1.5,5.4,0.5,96.8,36232,22099,20542,106,257,588,2060,8355,8355,192,37141,15376,40.9,53.5,40.1,0.3,0.4,0.9,3.8,15690,20542,106,151,331,1472
W07000047,SWANSEA WEST,40066,40038,99.5,92.0,89.5,35.3,35.3,0.0,0.0,0.0,0.4,0.1,99.7,39877,36877,35854,0,0,17,161,14161,14161,28,39964,18650,10.0,89.5,46.5,0.0,0.0,0.0,0.4,4023,35854,0,0,17,144
W07000048,SWANSEA EAST,40076,40012,98.6,87.5,85.9,27.2,27.2,0.0,0.0,0.1,1.2,0.2,99.1,39534,35049,34434,1,3,29,478,10906,10906,68,39721,27404,12.7,85.9,68.4,0.0,0.0,0.1,1.1,5100,34434,1,2,26,449
W07000049,ABERAVON,32991,32969,97.2,74.2,74.1,1.5,1.5,0.1,0.2,0.3,2.7,0.1,99.0,32069,24467,24458,26,61,96,900,480,480,34,32662,15320,23.1,74.1,46.4,0.1,0.1,0.1,2.4,7611,24458,26,35,35,804
W07000050,CARDIFF CENTRAL,40214,40144,95.2,81.2,78.4,43.2,43.2,0.0,0.0,0.4,4.6,0.2,95.4,38278,32642,31526,0,20,171,1866,17357,17357,69,38351,26208,16.8,78.4,65.2,0.0,0.0,0.4,4.2,6752,31526,0,20,151,1695
W07000051,CARDIFF NORTH,39730,39714,98.2,87.5,83.9,62.9,62.9,0.1,0.1,0.6,1.7,0.0,99.5,39034,34764,33320,26,55,238,680,24979,24979,19,39541,28524,14.4,83.9,71.8,0.1,0.1,0.5,1.1,5714,33320,26,29,183,442
W07000052,RHONDDA,35720,35652,98.5,0.5,0.5,0.5,0.5,0.0,0.0,0.0,1.3,0.2,99.8,35202,174,174,2,3,6,450,174,174,69,35642,1979,98.1,0.5,5.5,0.0,0.0,0.0,1.2,35028,174,2,1,3,444
W07000053,TORFAEN,41026,40959,96.0,46.8,37.8,5.7,5.7,0.1,0.3,1.2,3.8,0.4,97.6,39394,19193,15503,40,138,510,1565,2334,2334,157,40049,26172,58.2,37.8,63.8,0.1,0.2,0.9,2.6,23891,15503,40,98,372,1055
W07000054,MONMOUTH,41781,41583,85.5,27.4,20.2,15.2,15.2,1.6,3.7,6.6,14.0,2.8,95.4,35716,11451,8452,667,1528,2767,5867,6344,6344,1151,39872,3844,65.3,20.2,9.2,1.6,2.1,3.0,7.4,27264,8452,667,861,1239,3100
W07000055,NEWPORT EAST,37525,37477,97.4,71.2,66.2,6.0,6.0,0.1,0.3,1.0,2.5,0.3,98.0,36545,26723,24843,28,131,383,932,2236,2236,94,36790,9777,31.2,66.2,26.1,0.1,0.3,0.7,1.5,11702,24843,28,103,252,549
W07000056,NEWPORT WEST,42674,42635,97.5,67.0,62.8,8.3,8.3,0.1,0.3,0.5,2.4,0.2,98.6,41606,28588,26800,42,113,202,1029,3563,3563,65,42057,14937,34.7,62.8,35.0,0.1,0.2,0.2,1.9,14806,26800,42,71,89,827
W07000057,ARFON,29429,29349,92.7,20.8,17.2,14.7,14.7,0.5,1.2,2.6,7.0,0.7,96.2,27286,6120,5061,141,356,773,2063,4325,4325,198,28322,12011,75.5,17.2,40.8,0.5,0.7,1.4,4.4,22225,5061,141,215,417,1290
W07000058,ABERCONWY,30240,30207,92.7,8.0,8.0,8.0,8.0,0.7,2.0,3.4,7.2,1.2,97.1,28034,2431,2431,217,611,1022,2173,2431,2431,375,29365,14830,84.7,8.0,49.0,0.7,1.3,1.4,3.8,25603,2431,217,394,411,1151
W07000059,CLWYD WEST,36748,36647,89.8,7.9,7.9,7.9,7.9,1.4,3.2,5.5,10.0,1.7,95.3,32989,2911,2911,499,1160,2009,3658,2911,2911,620,35039,19949,81.8,7.9,54.3,1.4,1.8,2.3,4.5,30078,2911,499,661,849,1649
W07000060,VALE OF CLWYD,37768,37661,94.9,6.8,6.8,6.8,6.8,0.1,0.3,1.3,4.8,0.4,97.3,35857,2560,2560,38,121,483,1804,2560,2560,143,36756,15164,88.2,6.8,40.2,0.1,0.2,1.0,3.5,33297,2560,38,83,362,1321
W07000061,DWYFOR MEIRIONNYDD,38416,38147,82.9,16.4,16.4,16.4,16.4,1.9,5.0,8.4,16.4,3.3,91.3,31843,6318,6318,737,1918,3235,6304,6318,6318,1264,35065,4,66.4,16.4,0.0,1.9,3.1,3.4,8.0,25525,6318,737,1181,1317,3069
W07000062,CLWYD SOUTH,34693,34520,91.0,16.1,15.1,14.1,14.1,0.9,2.3,4.3,8.5,1.5,96.2,31562,5593,5240,303,787,1487,2958,4906,4906,528,33375,13457,75.9,15.1,38.8,0.9,1.4,2.0,4.2,26322,5240,303,484,700,1471
W07000063,MONTGOMERYSHIRE,32240,31838,79.7,20.0,20.0,20.0,20.0,3.3,7.1,11.8,19.0,5.7,90.8,25704,6463,6462,1074,2296,3800,6134,6462,6462,1846,29265,4797,59.7,20.0,14.9,3.3,3.8,4.7,7.2,19242,6462,1074,1222,1504,2334
W07000064,CEREDIGION,37566,37319,80.3,20.0,20.0,20.0,20.0,3.0,7.1,11.7,19.0,4.6,89.0,30170,7528,7528,1143,2661,4389,7149,7528,7528,1738,33450,1262,60.3,20.0,3.4,3.0,4.0,4.6,7.3,22642,7528,1143,1518,1728,2760
W07000065,PRESELI PEMBROKESHIRE,40451,40352,85.6,7.0,7.0,7.0,7.0,2.3,5.2,8.4,14.2,2.6,94.1,34613,2848,2848,948,2112,3390,5739,2848,2848,1069,38081,3325,78.5,7.0,8.2,2.3,2.9,3.2,5.8,31765,2848,948,1164,1278,2349
W07000066,CARMARTHEN WEST AND SOUTH PEMBROKESHIRE,41667,41554,88.0,10.4,10.4,10.4,10.4,1.6,3.6,5.9,11.7,2.4,95.4,36673,4318,4318,659,1510,2464,4881,4313,4313,980,39745,1542,77.7,10.4,3.7,1.6,2.0,2.3,5.8,32355,4318,659,851,954,2417
W07000067,CARMARTHEN EAST AND DINEFWR,35899,35457,78.7,13.3,13.3,13.3,13.3,3.2,7.0,10.8,20.0,4.0,88.4,28270,4781,4781,1154,2504,3871,7187,4781,4781,1440,31723,6855,65.4,13.3,19.1,3.2,3.8,3.8,9.2,23489,4781,1154,1350,1367,3316
W07000068,BRECON AND RADNORSHIRE,37018,36365,75.5,13.1,13.1,13.1,13.1,3.5,7.5,12.7,22.7,5.7,86.0,27954,4854,4854,1299,2767,4688,8411,4852,4852,2112,31823,122,62.4,13.1,0.3,3.5,4.0,5.2,10.1,23100,4854,1299,1468,1921,3723
W07000069,NEATH,35906,35880,96.6,43.4,43.3,4.3,4.3,0.1,0.2,0.5,3.4,0.2,99.5,34675,15566,15564,29,80,171,1205,1558,1558,80,35739,9119,53.2,43.3,25.4,0.1,0.1,0.3,2.9,19111,15564,29,51,91,1034
W07000070,CYNON VALLEY,35632,35428,96.6,8.3,5.8,4.0,4.0,0.1,0.2,0.6,2.9,1.1,98.6,34408,2975,2053,30,56,223,1020,1425,1425,380,35136,7840,90.8,5.8,22.0,0.1,0.1,0.5,2.2,32355,2053,30,26,167,797
W07000071,MERTHYR TYDFIL AND RHYMNEY,36184,36140,97.1,8.7,8.7,8.7,8.7,0.1,0.2,0.4,2.7,0.1,99.6,35146,3163,3163,47,87,159,994,3163,3163,53,36038,2900,88.4,8.7,8.0,0.1,0.1,0.2,2.3,31983,3163,47,40,72,835
W07000072,BLAENAU GWENT,35222,35156,96.4,5.0,3.6,2.4,2.4,0.1,0.2,0.7,3.4,0.3,99.4,33971,1769,1283,19,76,245,1185,860,860,110,34997,18,92.8,3.6,0.1,0.1,0.2,0.5,2.7,32688,1283,19,57,169,940
W07000073,BRIDGEND,38961,38923,97.2,52.9,41.9,35.2,35.2,0.0,0.1,0.8,2.7,0.1,98.3,37872,20623,16320,6,27,299,1051,13715,13715,39,38292,18634,55.3,41.9,47.8,0.0,0.1,0.7,1.9,21552,16320,6,21,272,752
W07000074,OGMORE,36138,36083,96.3,26.4,17.6,10.9,10.9,0.1,0.2,0.8,3.6,0.2,99.2,34800,9527,6362,26,61,299,1283,3951,3951,64,35849,8196,78.7,17.6,22.7,0.1,0.1,0.7,2.7,28438,6362,26,35,238,984
W07000075,PONTYPRIDD,39485,39377,97.0,45.8,36.7,9.4,9.4,0.1,0.1,0.7,2.8,0.3,98.7,38290,18090,14502,24,43,265,1087,3692,3692,110,38984,19964,60.2,36.7,50.6,0.1,0.0,0.6,2.1,23788,14502,24,19,222,822
W07000076,CAERPHILLY,40031,40006,98.1,31.9,20.9,13.6,13.6,0.0,0.1,0.1,1.8,0.1,99.8,39281,12770,8356,16,29,56,725,5435,5436,27,39943,27939,77.3,20.9,69.8,0.0,0.0,0.1,1.7,30925,8356,16,13,27,669
W07000077,ISLWYN,35263,35237,97.5,22.5,21.7,21.4,21.4,0.1,0.2,0.3,2.4,0.1,99.8,34375,7921,7653,24,53,106,862,7546,7546,26,35184,11222,75.8,21.7,31.8,0.1,0.1,0.2,2.1,26722,7653,24,29,53,756
W07000078,VALE OF GLAMORGAN,48253,48111,96.0,57.2,54.1,28.3,28.3,0.3,0.9,1.4,3.7,0.7,98.1,46345,27591,26118,135,437,698,1766,13661,13661,354,47349,1005,41.9,54.1,2.1,0.3,0.6,0.5,2.2,20227,26118,135,302,261,1068
W07000079,CARDIFF WEST,43929,43875,99.1,86.4,84.1,28.0,28.0,0.0,0.0,0.1,0.7,0.1,99.7,43548,37954,36938,3,16,24,327,12316,12316,52,43807,23700,15.0,84.1,54.0,0.0,0.0,0.0,0.7,6610,36938,3,13,8,303
W07000080,CARDIFF SOUTH AND PENARTH,55999,55921,98.1,82.2,78.4,32.3,32.3,0.0,0.5,1.0,1.8,0.1,98.3,54921,46047,43925,8,280,543,1000,18111,18111,81,55048,30864,19.6,78.4,55.1,0.0,0.5,0.5,0.8,10996,43925,8,272,263,457
