parl_const,parliamentary_constituency_name,All Premises,All Matched Premises,SFBB availability (% premises),UFBB (100Mbit/s) availability (% premises),UFBB availability (% premises),Full Fibre availability (% premises),Gigabit availability (% premises),% of premises unable to receive 2Mbit/s,% of premises unable to receive 5Mbit/s,% of premises unable to receive 10Mbit/s,% of premises unable to receive 30Mbit/s,% of premises below the USO,% of premises with NGA,Number of premises with SFBB availability,Number of premises with UFBB (100Mbit/s) availability,Number of premises with UFBB availability,Number of premises unable to receive 2Mbit/s,Number of premises unable to receive 5Mbit/s,Number of premises unable to receive 10Mbit/s,Number of premises unable to receive 30Mbit/s,Number of premises with Full Fibre availability,Number of premises with Gigabit availability,Number of premises below the USO,Number of premises with NGA,Number of premises able to receive decent broadband from FWA,% of premises with 30<300Mbit/s download speed,% of premises with >=300Mbit/s download speed,% of premises able to receive decent broadband from FWA,% of premises with 0<2Mbit/s download speed,% of premises with 2<5Mbit/s download speed,% of premises with 5<10Mbit/s download speed,% of premises with 10<30Mbit/s download speed,Number of premises with 30<300Mbit/s download speed,Number of premises with >=300Mbit/s download speed,Number of premises with 0<2Mbit/s download speed,Number of premises with 2<5Mbit/s download speed,Number of premises with 5<10Mbit/s download speed,Number of premises with 10<30Mbit/s download speed
E14000530,ALDERSHOT,47679,47503,97.0,82.0,81.7,4.8,46.6,0.1,0.8,1.5,2.6,0.4,97.4,46266,39086,38976,52,384,724,1237,2310,22211,181,46431,0,15.3,81.7,0.0,0.1,0.7,0.7,1.1,7290,38976,52,332,340,513
E14000531,ALDRIDGE-BROWNHILLS,34179,34121,97.9,83.7,79.8,17.5,78.5,0.0,0.0,0.4,1.9,0.0,98.6,33462,28601,27281,2,4,137,659,5989,26819,8,33707,0,18.1,79.8,0.0,0.0,0.0,0.4,1.5,6181,27281,2,2,133,522
E14000532,ALTRINCHAM AND SALE WEST,45091,44986,96.7,70.4,62.1,2.6,55.9,0.1,0.4,0.5,3.0,0.0,98.9,43620,31748,28024,57,183,237,1366,1185,25220,18,44582,107,34.6,62.1,0.2,0.1,0.3,0.1,2.5,15596,28024,57,126,54,1129
E14000533,AMBER VALLEY,44260,43969,95.2,27.9,27.3,27.0,27.0,0.0,0.2,0.5,4.2,0.2,98.8,42126,12365,12068,17,71,224,1843,11945,11945,78,43740,1,67.9,27.3,0.0,0.0,0.1,0.3,3.7,30058,12068,17,54,153,1619
E14000534,ARUNDEL AND SOUTH DOWNS,49318,48899,90.3,12.0,10.8,10.1,10.1,0.4,1.2,2.5,8.9,1.1,98.3,44528,5898,5324,221,612,1212,4371,4963,4963,519,48470,0,79.5,10.8,0.0,0.4,0.8,1.2,6.4,39204,5324,221,391,600,3159
E14000535,ASHFIELD,50050,49821,97.7,87.6,87.3,4.0,4.0,0.0,0.4,0.6,1.8,0.0,98.6,48917,43822,43683,11,216,277,904,2017,2017,24,49360,0,10.5,87.3,0.0,0.0,0.4,0.1,1.3,5234,43683,11,205,61,627
E14000536,ASHFORD,56767,56388,91.6,53.8,50.7,12.2,46.5,0.2,1.4,2.7,7.7,0.6,98.2,52002,30523,28790,133,776,1560,4386,6912,26378,331,55742,19545,40.9,50.7,34.4,0.2,1.1,1.4,5.0,23212,28790,133,643,784,2826
E14000537,ASHTON-UNDER-LYNE,47947,47755,98.5,81.6,80.9,40.1,79.8,0.0,0.0,0.1,1.1,0.0,99.1,47241,39143,38786,2,11,52,514,19231,38239,0,47530,0,17.6,80.9,0.0,0.0,0.0,0.1,1.0,8455,38786,2,9,41,462
E14000538,AYLESBURY,54190,53823,96.5,68.9,63.2,11.2,58.3,0.0,0.2,0.4,2.9,0.1,98.5,52267,37356,34243,15,127,226,1556,6052,31605,60,53360,1,33.3,63.2,0.0,0.0,0.2,0.2,2.5,18024,34243,15,112,99,1330
E14000539,BANBURY,60777,60252,95.8,44.3,34.7,14.7,14.7,0.3,0.5,1.1,3.4,0.2,97.9,58202,26903,21082,172,307,671,2050,8920,8920,119,59497,254,61.1,34.7,0.4,0.3,0.2,0.6,2.3,37120,21082,172,135,364,1379
E14000540,BARKING,53436,53376,98.3,88.6,88.4,49.5,88.4,0.0,0.3,0.7,1.6,0.0,98.3,52505,47353,47237,4,176,383,871,26461,47254,11,52526,0,9.9,88.4,0.0,0.0,0.3,0.4,0.9,5268,47237,4,172,207,488
E14000541,BARNSLEY CENTRAL,45348,45152,98.6,87.1,85.8,19.0,19.0,0.0,0.1,0.3,1.0,0.0,99.1,44701,39480,38911,1,57,114,451,8600,8603,2,44921,8728,12.8,85.8,19.2,0.0,0.1,0.1,0.7,5790,38911,1,56,57,337
E14000542,BARNSLEY EAST,44728,44521,98.3,82.1,79.4,41.8,41.8,0.0,0.1,0.2,1.3,0.0,99.0,43958,36705,35533,17,45,95,563,18678,18678,5,44279,4031,18.8,79.4,9.0,0.0,0.1,0.1,1.0,8425,35533,17,28,50,468
E14000543,BARROW AND FURNESS,46347,46119,96.7,4.6,4.6,4.6,4.6,0.2,0.5,0.8,2.8,0.4,99.3,44806,2135,2135,98,221,373,1313,2135,2135,195,46033,1251,92.1,4.6,2.7,0.2,0.3,0.3,2.0,42671,2135,98,123,152,940
E14000544,BASILDON AND BILLERICAY,43649,43485,97.3,79.7,78.3,30.8,30.8,0.1,0.3,0.6,2.4,0.0,99.0,42458,34804,34184,24,131,272,1027,13441,13441,4,43214,0,19.0,78.3,0.0,0.1,0.2,0.3,1.7,8274,34184,24,107,141,755
E14000545,BASINGSTOKE,53099,52989,98.0,75.6,74.6,31.8,74.6,0.0,0.2,0.3,1.8,0.0,98.6,52029,40144,39611,0,88,144,960,16862,39611,15,52332,0,23.4,74.6,0.0,0.0,0.2,0.1,1.5,12418,39611,0,88,56,816
E14000546,BASSETLAW,52955,52556,95.7,37.7,35.7,10.4,10.4,0.3,0.6,1.0,3.6,0.3,98.7,50655,19981,18920,185,326,546,1901,5486,5487,155,52278,10922,59.9,35.7,20.6,0.3,0.3,0.4,2.6,31735,18920,185,141,220,1355
E14000547,BATH,45526,45324,95.3,69.5,61.3,27.1,27.1,0.0,0.0,0.1,4.3,0.0,96.2,43369,31630,27901,0,10,68,1955,12336,12337,1,43782,0,34.0,61.3,0.0,0.0,0.0,0.1,4.1,15468,27901,0,10,58,1887
E14000548,BATLEY AND SPEN,49952,49719,96.9,79.7,79.6,53.1,54.3,0.0,0.1,0.1,2.6,0.0,98.9,48415,39827,39760,3,27,61,1304,26535,27099,1,49396,0,17.3,79.6,0.0,0.0,0.0,0.1,2.5,8655,39760,3,24,34,1243
E14000549,BATTERSEA,63129,62460,96.8,92.8,89.2,39.9,85.7,0.0,0.0,0.1,2.1,0.0,96.8,61107,58601,56313,0,0,58,1353,25203,54133,2,61114,0,7.6,89.2,0.0,0.0,0.0,0.1,2.1,4794,56313,0,0,58,1295
E14000550,BEACONSFIELD,47056,46891,93.7,57.6,53.8,35.0,44.3,0.0,0.3,1.4,5.9,0.2,98.1,44093,27084,25309,16,159,653,2798,16453,20849,114,46140,0,39.9,53.8,0.0,0.0,0.3,1.0,4.6,18784,25309,16,143,494,2145
E14000551,BECKENHAM,40891,40833,99.1,87.8,87.2,2.2,86.6,0.0,0.0,0.1,0.8,0.0,99.4,40512,35912,35656,2,4,26,321,889,35413,5,40652,0,11.9,87.2,0.0,0.0,0.0,0.1,0.7,4856,35656,2,2,22,295
E14000552,BEDFORD,50260,50104,98.2,91.3,88.1,9.8,35.1,0.0,0.1,0.2,1.5,0.0,98.4,49357,45890,44284,4,46,118,747,4945,17649,1,49464,0,10.1,88.1,0.0,0.0,0.1,0.1,1.3,5073,44284,4,42,72,629
E14000553,BERMONDSEY AND OLD SOUTHWARK,76553,75973,91.3,77.2,76.4,63.4,76.4,0.0,0.0,0.1,7.9,0.0,91.3,69913,59130,58515,0,7,102,6060,48540,58518,0,69927,0,14.9,76.4,0.0,0.0,0.0,0.1,7.8,11398,58515,0,7,95,5958
E14000554,BERWICK-UPON-TWEED,39877,39640,89.0,9.3,9.3,9.3,9.3,1.3,3.0,4.6,10.4,1.9,96.3,35501,3710,3708,528,1183,1844,4139,3707,3707,751,38400,3413,79.7,9.3,8.6,1.3,1.6,1.7,5.8,31793,3708,528,655,661,2295
E14000555,BETHNAL GREEN AND BOW,66448,65848,91.8,72.3,67.2,45.8,64.1,0.0,0.0,0.6,7.3,0.0,91.8,60977,48022,44681,0,0,393,4871,30462,42570,0,60998,0,24.5,67.2,0.0,0.0,0.0,0.6,6.7,16296,44681,0,0,393,4478
E14000556,BEVERLEY AND HOLDERNESS,49238,48634,95.6,72.6,72.6,72.6,72.6,0.4,0.9,1.4,3.1,0.3,97.5,47084,35726,35726,202,425,691,1550,35726,35726,131,48012,19917,23.1,72.6,40.5,0.4,0.5,0.5,1.7,11358,35726,202,223,266,859
E14000557,BEXHILL AND BATTLE,52862,52469,94.1,15.2,15.2,15.2,15.2,0.1,0.3,1.1,5.2,0.3,98.9,49727,8013,8013,34,159,575,2742,8013,8013,166,52280,0,78.9,15.2,0.0,0.1,0.2,0.8,4.1,41714,8013,34,125,416,2167
E14000558,BEXLEYHEATH AND CRAYFORD,39313,39218,97.6,91.2,91.1,60.3,91.0,0.0,0.0,0.6,2.2,0.0,97.7,38352,35865,35799,0,2,248,866,23708,35789,1,38415,0,6.5,91.1,0.0,0.0,0.0,0.6,1.6,2553,35799,0,2,246,618
E14000559,BIRKENHEAD,46964,46862,99.4,93.1,92.6,78.0,78.0,0.0,0.0,0.0,0.4,0.0,99.7,46664,43731,43508,0,0,6,198,36616,36616,0,46800,0,6.7,92.6,0.0,0.0,0.0,0.0,0.4,3156,43508,0,0,6,192
E14000560,"BIRMINGHAM, EDGBASTON",45157,44036,94.0,88.0,87.6,40.1,87.5,0.0,0.2,0.6,3.5,0.0,94.2,42455,39750,39567,14,79,266,1581,18121,39524,0,42517,0,6.4,87.6,0.0,0.0,0.1,0.4,2.9,2888,39567,14,65,187,1315
E14000561,"BIRMINGHAM, ERDINGTON",45626,45555,96.0,90.9,88.4,14.3,87.0,0.0,0.6,2.3,3.9,0.0,96.0,43782,41473,40320,1,276,1029,1773,6522,39676,1,43786,0,7.6,88.4,0.0,0.0,0.6,1.7,1.6,3462,40320,1,275,753,744
E14000562,"BIRMINGHAM, HALL GREEN",43842,43763,97.9,92.5,92.0,38.6,91.6,0.0,0.0,0.1,1.9,0.0,98.1,42924,40574,40323,0,6,51,839,16918,40172,0,42998,0,5.9,92.0,0.0,0.0,0.0,0.1,1.8,2601,40323,0,6,45,788
E14000563,"BIRMINGHAM, HODGE HILL",42567,42509,99.4,96.9,96.3,19.7,95.8,0.0,0.2,0.4,0.5,0.0,99.4,42301,41248,40995,0,68,159,208,8368,40775,1,42309,0,3.1,96.3,0.0,0.0,0.2,0.2,0.1,1306,40995,0,68,91,49
E14000564,"BIRMINGHAM, LADYWOOD",71521,69994,83.7,74.1,70.1,34.3,67.9,0.0,0.1,0.8,14.2,0.0,83.7,59837,52976,50152,0,43,548,10157,24533,48582,2,59840,0,13.5,70.1,0.0,0.0,0.1,0.7,13.4,9685,50152,0,43,505,9609
E14000565,"BIRMINGHAM, NORTHFIELD",47961,47905,97.3,92.6,92.3,15.1,92.3,0.0,0.0,1.3,2.6,0.0,97.5,46679,44399,44254,1,22,607,1226,7265,44254,0,46752,0,5.1,92.3,0.0,0.0,0.0,1.2,1.3,2425,44254,1,21,585,619
E14000566,"BIRMINGHAM, PERRY BARR",43402,43227,97.4,96.3,95.3,71.4,94.8,0.0,0.1,0.4,2.2,0.0,97.4,42266,41814,41377,5,51,168,961,30986,41141,0,42267,0,2.0,95.3,0.0,0.0,0.1,0.3,1.8,889,41377,5,46,117,793
E14000567,"BIRMINGHAM, SELLY OAK",45101,44569,97.1,93.8,93.6,40.8,93.8,0.0,0.0,0.4,1.7,0.0,97.2,43789,42298,42236,0,21,167,780,18392,42283,0,43853,0,3.4,93.6,0.0,0.0,0.0,0.3,1.4,1553,42236,0,21,146,613
E14000568,"BIRMINGHAM, YARDLEY",46210,46114,98.3,96.9,96.3,77.3,96.0,0.0,0.2,0.8,1.5,0.0,98.3,45427,44792,44478,9,71,386,687,35731,44368,0,45429,0,2.1,96.3,0.0,0.0,0.1,0.7,0.7,949,44478,9,62,315,301
E14000569,BISHOP AUCKLAND,46952,46709,91.6,38.4,38.4,38.4,38.4,1.0,2.1,3.1,7.8,1.2,98.1,43025,18049,18049,467,970,1441,3684,18048,18048,575,46081,71,53.2,38.4,0.2,1.0,1.1,1.0,4.8,24976,18049,467,503,471,2243
E14000570,BLACKBURN,47794,47514,97.9,74.7,74.4,7.8,7.8,0.0,0.1,0.2,1.5,0.0,98.5,46802,35686,35570,1,56,84,712,3729,3742,6,47060,32359,23.5,74.4,67.7,0.0,0.1,0.1,1.3,11232,35570,1,55,28,628
E14000571,BLACKLEY AND BROUGHTON,53154,52997,95.6,71.8,66.9,21.7,64.4,0.0,0.1,1.7,4.1,0.0,96.3,50799,38182,35542,9,47,915,2198,11516,34246,3,51195,0,28.7,66.9,0.0,0.0,0.1,1.6,2.4,15257,35542,9,38,868,1283
E14000572,BLACKPOOL NORTH AND CLEVELEYS,44434,44355,98.7,54.5,54.3,2.8,2.8,0.0,0.0,0.1,1.2,0.0,99.2,43837,24211,24147,2,10,28,518,1258,1259,0,44073,454,44.3,54.3,1.0,0.0,0.0,0.0,1.1,19690,24147,2,8,18,490
E14000573,BLACKPOOL SOUTH,45495,45272,97.8,70.2,69.9,0.8,0.8,0.0,0.0,0.0,1.7,0.0,97.9,44496,31919,31806,1,3,9,776,364,364,1,44551,6623,27.9,69.9,14.6,0.0,0.0,0.0,1.7,12690,31806,1,2,6,767
E14000574,BLAYDON,44508,44092,92.9,49.5,48.3,7.7,7.7,0.1,0.5,1.5,6.2,0.1,96.5,41329,22012,21486,49,210,675,2763,3408,3409,35,42951,1,44.6,48.3,0.0,0.1,0.4,1.0,4.7,19843,21486,49,161,465,2088
E14000575,BLYTH VALLEY,41443,41343,98.3,37.6,26.1,18.9,18.9,0.1,0.1,0.1,1.5,0.0,99.7,40738,15580,10804,23,32,43,605,7819,7819,9,41334,0,72.2,26.1,0.0,0.1,0.0,0.0,1.4,29934,10804,23,9,11,562
E14000576,BOGNOR REGIS AND LITTLEHAMPTON,52271,52060,96.6,13.9,13.9,13.9,13.9,0.1,0.1,0.2,3.0,0.0,99.2,50514,7272,7272,48,59,90,1546,7272,7272,4,51869,0,82.7,13.9,0.0,0.1,0.0,0.1,2.8,43242,7272,48,11,31,1456
E14000577,BOLSOVER,48497,48289,93.4,36.2,32.2,13.7,13.7,0.0,0.2,0.5,6.2,0.2,98.1,45299,17576,15639,21,99,220,2990,6630,6630,73,47578,0,61.2,32.2,0.0,0.0,0.2,0.2,5.7,29660,15639,21,78,121,2770
E14000578,BOLTON NORTH EAST,47456,47192,98.6,90.3,88.1,5.4,86.8,0.0,0.1,0.2,0.8,0.0,99.1,46798,42868,41823,0,32,98,394,2567,41175,0,47031,0,10.5,88.1,0.0,0.0,0.1,0.1,0.6,4975,41823,0,32,66,296
E14000579,BOLTON SOUTH EAST,47632,47422,98.3,89.9,89.0,27.8,87.7,0.0,0.2,0.2,1.3,0.1,98.7,46819,42826,42373,10,73,93,603,13228,41777,33,47023,0,9.3,89.0,0.0,0.0,0.1,0.0,1.1,4446,42373,10,63,20,510
E14000580,BOLTON WEST,46150,46020,97.6,84.2,82.9,4.8,82.3,0.0,0.1,0.3,2.1,0.1,99.1,45064,38842,38258,13,27,157,956,2222,38001,34,45735,4588,14.7,82.9,9.9,0.0,0.0,0.3,1.7,6806,38258,13,14,130,799
E14000581,BOOTLE,50038,49954,99.1,91.1,90.7,47.4,90.7,0.0,0.1,0.2,0.7,0.0,99.4,49582,45569,45396,4,44,106,372,23700,45396,5,49719,0,8.4,90.7,0.0,0.0,0.1,0.1,0.5,4186,45396,4,40,62,266
E14000582,BOSTON AND SKEGNESS,53842,53229,89.2,15.5,10.8,7.5,7.5,0.7,2.0,3.6,9.7,0.6,96.5,48006,8337,5815,403,1079,1965,5223,4015,4015,325,51966,25355,78.4,10.8,47.1,0.7,1.3,1.6,6.1,42191,5815,403,676,886,3258
E14000583,BOSWORTH,51569,51184,96.4,63.4,60.3,9.7,9.7,0.1,0.8,1.1,2.8,0.2,98.3,49736,32687,31074,31,437,556,1448,5023,5025,109,50678,0,36.2,60.3,0.0,0.1,0.8,0.2,1.7,18662,31074,31,406,119,892
E14000584,BOURNEMOUTH EAST,51907,51734,98.3,92.6,89.5,58.5,86.1,0.6,0.6,0.9,1.4,0.0,99.3,51025,48072,46467,298,300,451,709,30355,44705,0,51551,5,8.8,89.5,0.0,0.6,0.0,0.3,0.5,4558,46467,298,2,151,258
E14000585,BOURNEMOUTH WEST,53224,52737,98.5,83.1,79.7,44.8,52.9,0.0,0.0,0.1,0.6,0.0,98.8,52403,44253,42429,0,14,32,334,23862,28148,0,52593,193,18.7,79.7,0.4,0.0,0.0,0.0,0.6,9974,42429,0,14,18,302
E14000586,BRACKNELL,49576,49196,95.2,59.4,56.1,10.1,54.4,0.0,0.1,0.7,4.0,0.0,97.2,47220,29462,27815,3,28,364,1976,5027,26991,21,48170,546,39.1,56.1,1.1,0.0,0.1,0.7,3.3,19405,27815,3,25,336,1612
E14000587,BRADFORD EAST,44973,44889,97.9,87.9,87.2,7.5,83.5,0.0,0.1,0.2,1.9,0.0,98.3,44049,39528,39203,0,36,71,840,3359,37543,0,44207,10918,10.8,87.2,24.3,0.0,0.1,0.1,1.7,4846,39203,0,36,35,769
E14000588,BRADFORD SOUTH,45452,45405,97.8,86.0,84.6,6.1,79.1,0.0,0.2,0.3,2.1,0.0,99.0,44464,39086,38446,7,89,153,941,2773,35972,0,44977,939,13.2,84.6,2.1,0.0,0.2,0.1,1.7,6018,38446,7,82,64,788
E14000589,BRADFORD WEST,41826,41153,94.5,84.8,83.3,4.0,80.7,0.0,0.2,0.4,3.9,0.0,95.0,39517,35456,34834,8,76,158,1636,1663,33763,2,39730,3709,11.2,83.3,8.9,0.0,0.2,0.2,3.5,4683,34834,8,68,82,1478
E14000590,BRAINTREE,47422,47136,95.2,31.6,31.6,31.5,31.5,0.2,0.7,1.1,4.2,0.3,98.2,45148,14978,14978,118,318,545,1988,14950,14950,151,46562,6096,63.6,31.6,12.9,0.2,0.4,0.5,3.0,30170,14978,118,200,227,1443
E14000591,BRENT CENTRAL,67033,66095,94.9,70.7,65.7,44.0,63.5,0.0,0.6,1.3,3.7,0.0,95.0,63643,47405,44020,0,386,902,2452,29471,42589,1,63692,0,29.3,65.7,0.0,0.0,0.6,0.8,2.3,19623,44020,0,386,516,1550
E14000592,BRENT NORTH,49839,49444,97.2,86.4,85.3,36.8,84.5,0.0,0.1,0.2,2.0,0.0,97.2,48428,43081,42492,3,53,103,1016,18348,42116,0,48440,0,11.9,85.3,0.0,0.0,0.1,0.1,1.8,5936,42492,3,50,50,913
E14000593,BRENTFORD AND ISLEWORTH,56686,55923,96.4,85.6,85.3,15.2,85.3,0.0,0.1,0.2,2.2,0.0,96.6,54672,48538,48371,0,41,140,1251,8622,48348,2,54737,0,11.1,85.3,0.0,0.0,0.1,0.2,2.0,6301,48371,0,41,99,1111
E14000594,BRENTWOOD AND ONGAR,45555,45216,94.7,50.4,50.4,44.7,50.4,0.1,0.3,0.8,4.5,0.2,97.3,43160,22967,22966,56,159,355,2056,20373,22964,107,44319,758,44.3,50.4,1.7,0.1,0.2,0.4,3.7,20194,22966,56,103,196,1701
E14000595,BRIDGWATER AND WEST SOMERSET,57711,57381,90.3,30.6,24.0,20.5,20.5,0.8,2.1,3.8,9.1,1.1,97.0,52104,17664,13874,449,1189,2179,5277,11813,11813,622,55952,4251,66.2,24.0,7.4,0.8,1.3,1.7,5.4,38230,13874,449,740,990,3098
E14000596,BRIGG AND GOOLE,42005,41745,92.2,35.4,35.4,32.4,35.3,0.7,1.4,1.9,7.2,0.3,96.9,38741,14864,14861,303,592,804,3004,13625,14844,142,40686,25727,56.9,35.4,61.2,0.7,0.7,0.5,5.2,23880,14861,303,289,212,2200
E14000597,"BRIGHTON, KEMPTOWN",46121,45874,97.3,77.5,77.0,21.0,21.0,0.0,0.0,0.1,2.1,0.0,98.2,44884,35766,35536,0,3,41,990,9680,9680,11,45290,0,20.3,77.0,0.0,0.0,0.0,0.1,2.1,9348,35536,0,3,38,949
E14000598,"BRIGHTON, PAVILION",54707,53687,95.4,85.1,82.4,27.9,27.9,0.0,0.4,1.5,2.7,0.0,95.6,52196,46554,45101,4,201,828,1491,15287,15288,7,52294,0,13.0,82.4,0.0,0.0,0.4,1.1,1.2,7095,45101,4,197,627,663
E14000599,BRISTOL EAST,46752,46526,97.2,90.9,90.4,44.4,87.0,0.0,0.2,0.7,2.3,0.3,97.3,45437,42508,42248,3,77,320,1089,20767,40655,159,45484,0,6.8,90.4,0.0,0.0,0.2,0.5,1.6,3189,42248,3,74,243,769
E14000600,BRISTOL NORTH WEST,45968,45866,97.3,88.8,88.0,19.6,87.8,0.0,0.1,0.7,2.5,0.1,97.9,44728,40839,40464,2,53,333,1138,9023,40381,62,44987,38,9.3,88.0,0.1,0.0,0.1,0.6,1.8,4264,40464,2,51,280,805
E14000601,BRISTOL SOUTH,52606,52134,97.9,95.3,95.0,80.2,80.2,0.0,0.0,0.2,1.2,0.0,98.0,51515,50158,49997,6,19,96,619,42179,42181,0,51537,0,2.9,95.0,0.0,0.0,0.0,0.1,1.0,1518,49997,6,13,77,523
E14000602,BRISTOL WEST,66242,65565,91.6,85.8,84.0,52.3,79.5,0.0,0.0,0.4,7.4,0.0,91.6,60654,56837,55670,1,1,248,4911,34619,52686,11,60660,0,7.5,84.0,0.0,0.0,0.0,0.4,7.0,4984,55670,1,0,247,4663
E14000603,BROADLAND,48459,48151,91.3,17.1,13.7,10.4,10.5,0.5,1.3,2.6,8.1,2.0,97.7,44219,8269,6648,222,636,1239,3932,5059,5066,972,47335,23,77.5,13.7,0.0,0.5,0.9,1.2,5.6,37571,6648,222,414,603,2693
E14000604,BROMLEY AND CHISLEHURST,42382,42277,97.5,87.1,87.0,16.1,85.1,0.0,0.0,0.1,2.2,0.0,98.4,41338,36927,36868,0,2,38,939,6821,36066,0,41706,0,10.5,87.0,0.0,0.0,0.0,0.1,2.1,4470,36868,0,2,36,901
E14000605,BROMSGROVE,45158,44898,96.9,73.7,73.6,53.6,73.6,0.0,0.3,0.6,2.5,0.1,99.1,43774,33281,33245,21,135,256,1124,24196,33245,60,44753,41,23.3,73.6,0.1,0.0,0.3,0.3,1.9,10529,33245,21,114,121,868
E14000606,BROXBOURNE,45478,45420,98.4,88.0,84.6,5.5,5.5,0.1,0.1,0.2,1.5,0.0,99.3,44746,40005,38484,25,36,100,674,2508,2508,5,45140,0,13.8,84.6,0.0,0.1,0.0,0.1,1.3,6262,38484,25,11,64,574
E14000607,BROXTOWE,45108,45006,98.7,91.9,90.9,13.3,13.3,0.0,0.1,0.2,1.0,0.0,99.4,44544,41461,40986,14,51,97,462,5994,5994,0,44833,0,7.9,90.9,0.0,0.0,0.1,0.1,0.8,3558,40986,14,37,46,365
E14000608,BUCKINGHAM,49749,49037,90.1,40.2,36.5,33.9,33.9,0.4,1.8,3.3,8.4,0.9,94.8,44843,19988,18144,213,875,1624,4194,16882,16889,445,47164,218,53.7,36.5,0.4,0.4,1.3,1.5,5.2,26699,18144,213,662,749,2570
E14000609,BURNLEY,45504,45290,97.8,79.0,79.0,1.9,79.0,0.1,0.1,0.3,1.7,0.0,99.1,44499,35940,35932,31,50,123,791,857,35931,15,45104,27833,18.8,79.0,61.2,0.1,0.0,0.2,1.5,8567,35932,31,19,73,668
E14000610,BURTON,51180,50809,95.4,43.0,39.0,34.5,34.5,0.2,0.6,1.1,3.9,0.1,98.7,48829,22005,19946,117,288,572,1980,17652,17652,67,50502,0,56.4,39.0,0.0,0.2,0.3,0.6,2.8,28883,19946,117,171,284,1408
E14000611,BURY NORTH,43416,42788,97.0,65.8,57.8,40.1,50.2,0.0,0.2,0.2,1.6,0.2,98.5,42101,28585,25109,11,71,106,687,17413,21806,98,42744,0,39.1,57.8,0.0,0.0,0.1,0.1,1.3,16992,25109,11,60,35,581
E14000612,BURY SOUTH,46528,45895,97.8,89.0,88.4,78.3,88.1,0.0,0.0,0.1,0.9,0.1,98.5,45490,41427,41136,0,10,45,405,36451,41000,41,45844,0,9.4,88.4,0.0,0.0,0.0,0.1,0.8,4354,41136,0,10,35,360
E14000613,BURY ST EDMUNDS,57068,56469,94.0,26.1,21.0,17.5,17.5,0.2,0.3,0.6,5.0,0.4,98.3,53643,14868,11979,89,186,353,2826,9985,9985,204,56085,0,73.0,21.0,0.0,0.2,0.2,0.3,4.3,41664,11979,89,97,167,2473
E14000614,CALDER VALLEY,52672,52377,91.8,34.0,33.9,9.7,9.7,0.2,0.6,1.1,7.6,0.1,98.0,48375,17932,17862,108,309,586,4002,5091,5092,75,51637,0,57.9,33.9,0.0,0.2,0.4,0.5,6.5,30513,17862,108,201,277,3416
E14000615,CAMBERWELL AND PECKHAM,57774,57471,96.0,83.1,82.5,52.9,82.4,0.0,0.1,0.2,3.5,0.0,96.0,55438,48013,47657,0,55,140,2033,30571,47592,0,55446,0,13.5,82.5,0.0,0.0,0.1,0.1,3.3,7781,47657,0,55,85,1893
E14000616,CAMBORNE AND REDRUTH,46776,46229,86.7,37.3,37.3,37.3,37.3,0.2,1.1,2.6,12.1,0.7,91.9,40566,17437,17430,100,492,1237,5663,17430,17430,343,43001,893,49.5,37.3,1.9,0.2,0.8,1.6,9.5,23136,17430,100,392,745,4426
E14000617,CAMBRIDGE,55937,55788,98.7,92.2,90.1,43.3,43.3,0.0,0.0,0.1,1.0,0.0,98.7,55214,51593,50383,1,19,73,574,24217,24217,2,55232,0,8.6,90.1,0.0,0.0,0.0,0.1,0.9,4831,50383,1,18,54,501
E14000618,CANNOCK CHASE,48031,47774,97.5,36.8,36.7,15.5,36.5,0.0,0.1,0.2,2.0,0.1,99.2,46810,17664,17619,16,38,105,964,7437,17555,58,47632,0,60.8,36.7,0.0,0.0,0.0,0.1,1.8,29191,17619,16,22,67,859
E14000619,CANTERBURY,53361,52972,93.2,13.6,13.6,13.6,13.6,0.3,0.7,1.3,6.1,0.3,98.9,49734,7269,7268,150,375,703,3238,7269,7269,158,52769,8955,79.6,13.6,16.8,0.3,0.4,0.6,4.8,42466,7268,150,225,328,2535
E14000620,CARLISLE,46142,45922,97.3,62.4,55.9,5.5,5.5,0.2,0.5,0.8,2.2,0.2,98.6,44893,28788,25792,83,214,356,1029,2547,2547,86,45504,0,41.4,55.9,0.0,0.2,0.3,0.3,1.5,19101,25792,83,131,142,673
E14000621,CARSHALTON AND WALLINGTON,42745,42627,98.2,86.2,84.8,8.6,84.6,0.0,0.0,0.2,1.5,0.0,98.7,41979,36860,36263,11,15,104,648,3693,36179,1,42172,0,13.4,84.8,0.0,0.0,0.0,0.2,1.3,5716,36263,11,4,89,544
E14000622,CASTLE POINT,41073,40716,98.3,44.2,44.2,2.8,2.8,0.0,0.1,0.2,0.8,0.0,98.8,40380,18157,18135,13,41,66,336,1164,1164,8,40565,0,54.2,44.2,0.0,0.0,0.1,0.1,0.7,22245,18135,13,28,25,270
E14000623,CENTRAL DEVON,45718,45271,77.5,22.9,22.7,21.2,21.2,1.8,5.5,10.6,21.5,2.3,92.4,35419,10488,10398,822,2513,4837,9852,9713,9713,1064,42222,23162,54.7,22.7,50.7,1.8,3.7,5.1,11.0,25021,10398,822,1691,2324,5015
E14000624,CENTRAL SUFFOLK AND NORTH IPSWICH,47435,47043,92.6,42.0,40.6,35.1,35.1,0.3,0.8,1.9,6.6,0.9,98.0,43914,19928,19280,138,390,890,3129,16632,16632,421,46472,159,51.9,40.6,0.3,0.3,0.5,1.1,4.7,24634,19280,138,252,500,2239
E14000625,CHARNWOOD,46068,45966,98.4,77.9,77.0,23.3,23.3,0.0,0.1,0.4,1.4,0.1,99.5,45335,35874,35480,17,53,163,631,10746,10746,66,45849,0,21.4,77.0,0.0,0.0,0.1,0.2,1.0,9855,35480,17,36,110,468
E14000626,CHATHAM AND AYLESFORD,44109,43985,98.2,87.2,84.1,7.5,7.5,0.0,0.1,0.5,1.5,0.0,98.9,43332,38478,37111,8,52,204,653,3312,3312,7,43634,3236,14.1,84.1,7.3,0.0,0.1,0.3,1.0,6221,37111,8,44,152,449
E14000627,CHEADLE,42832,42570,98.1,85.3,85.2,28.5,65.0,0.0,0.0,0.0,1.3,0.0,98.9,42002,36520,36508,1,8,18,568,12193,27835,19,42356,4381,12.8,85.2,10.2,0.0,0.0,0.0,1.3,5494,36508,1,7,10,550
E14000628,CHELMSFORD,52049,51912,98.1,85.9,83.2,54.4,54.4,0.0,0.0,0.0,1.6,0.0,98.6,51059,44693,43304,1,13,19,853,28327,28327,1,51304,14,14.9,83.2,0.0,0.0,0.0,0.0,1.6,7755,43304,1,12,6,834
E14000629,CHELSEA AND FULHAM,60824,60483,95.4,75.7,65.3,28.8,56.9,0.0,0.0,0.0,4.0,0.0,95.4,58040,46047,39728,0,0,1,2443,17540,34585,0,58043,0,30.1,65.3,0.0,0.0,0.0,0.0,4.0,18312,39728,0,0,1,2442
E14000630,CHELTENHAM,54470,54314,98.7,76.5,69.2,3.4,63.7,0.0,0.1,0.2,1.0,0.0,99.1,53769,41690,37704,11,32,121,545,1826,34717,5,53953,0,29.5,69.2,0.0,0.0,0.0,0.2,0.8,16065,37704,11,21,89,424
E14000631,CHESHAM AND AMERSHAM,42974,42842,94.4,50.9,50.3,11.2,11.2,0.0,1.1,2.0,5.3,0.1,99.3,40550,21861,21598,13,468,875,2292,4796,4802,49,42685,0,44.1,50.3,0.0,0.0,1.1,0.9,3.3,18952,21598,13,455,407,1417
E14000632,CHESTERFIELD,48258,48084,97.2,55.4,54.6,21.9,21.9,0.0,0.0,0.2,2.5,0.0,98.9,46900,26713,26366,0,13,96,1184,10551,10551,5,47727,0,42.6,54.6,0.0,0.0,0.0,0.2,2.3,20534,26366,0,13,83,1088
E14000633,CHICHESTER,57838,57064,91.0,27.1,24.7,22.9,22.9,0.3,0.8,1.6,7.6,0.8,97.9,52647,15677,14266,181,471,903,4417,13272,13272,436,56643,0,66.4,24.7,0.0,0.3,0.5,0.7,6.1,38381,14266,181,290,432,3514
E14000634,CHINGFORD AND WOODFORD GREEN,39731,39611,96.8,84.5,83.9,10.2,83.3,0.1,0.1,0.5,2.9,0.0,97.1,38446,33574,33354,34,55,200,1165,4033,33115,12,38572,0,12.8,83.9,0.0,0.1,0.1,0.4,2.4,5092,33354,34,21,145,965
E14000635,CHIPPENHAM,47517,47377,95.7,45.4,40.6,21.3,21.3,0.2,0.3,0.6,4.0,0.1,98.8,45455,21580,19270,79,163,278,1922,10127,10128,42,46924,0,55.1,40.6,0.0,0.2,0.2,0.2,3.5,26185,19270,79,84,115,1644
E14000636,CHIPPING BARNET,49104,48914,96.9,59.6,54.9,42.4,51.1,0.0,0.0,0.2,2.7,0.0,97.9,47591,29251,26941,0,6,86,1323,20831,25111,2,48083,0,42.1,54.9,0.0,0.0,0.0,0.2,2.5,20650,26941,0,6,80,1237
E14000637,CHORLEY,49874,49658,95.7,62.2,58.9,12.4,12.4,0.1,0.2,0.6,3.9,0.1,98.9,47727,31046,29378,27,105,298,1931,6194,6195,36,49344,16935,36.8,58.9,34.0,0.1,0.2,0.4,3.3,18349,29378,27,78,193,1633
E14000638,CHRISTCHURCH,44355,44074,95.3,44.4,44.3,14.9,44.2,0.1,0.1,0.2,4.1,0.3,99.1,42277,19675,19628,35,57,80,1797,6621,19596,144,43967,32,51.1,44.3,0.1,0.1,0.0,0.1,3.9,22649,19628,35,22,23,1717
E14000639,CITIES OF LONDON AND WESTMINSTER,112476,110737,82.2,68.3,67.7,64.2,67.4,0.0,0.0,0.1,16.2,0.0,82.2,92480,76781,76123,0,0,85,18257,72206,75772,13,92500,1,14.5,67.7,0.0,0.0,0.0,0.1,16.2,16357,76123,0,0,85,18172
E14000640,CITY OF CHESTER,48840,48636,95.9,52.0,38.9,29.6,29.6,0.1,0.2,0.8,3.7,0.0,98.1,46821,25399,18994,36,100,386,1815,14478,14478,17,47893,25,57.0,38.9,0.1,0.1,0.1,0.6,2.9,27827,18994,36,64,286,1429
E14000641,CITY OF DURHAM,45019,44800,95.9,44.1,43.9,43.8,43.8,0.1,0.2,0.3,3.6,0.0,99.0,43181,19834,19758,29,78,125,1619,19696,19696,19,44572,0,52.0,43.9,0.0,0.1,0.1,0.1,3.3,23423,19758,29,49,47,1494
E14000642,CLACTON,47543,47341,98.3,6.9,6.9,6.9,6.9,0.1,0.1,0.1,1.3,0.1,99.5,46744,3267,3267,26,39,65,597,3267,3267,25,47307,140,91.4,6.9,0.3,0.1,0.0,0.1,1.1,43477,3267,26,13,26,532
E14000643,CLEETHORPES,44951,44792,94.1,69.3,69.2,5.9,5.9,0.3,1.6,2.5,5.6,0.5,96.5,42297,31157,31123,129,724,1108,2495,2655,2655,211,43393,15020,24.9,69.2,33.4,0.3,1.3,0.9,3.1,11174,31123,129,595,384,1387
E14000644,COLCHESTER,56960,56603,97.8,73.0,72.7,8.0,8.0,0.0,0.0,0.2,1.6,0.0,98.3,55706,41566,41430,6,19,97,897,4563,4563,18,56007,429,25.1,72.7,0.8,0.0,0.0,0.1,1.4,14276,41430,6,13,78,800
E14000645,COLNE VALLEY,53240,53018,94.8,56.0,55.9,15.5,15.5,0.1,0.4,1.3,4.8,0.0,98.0,50470,29834,29786,69,237,669,2548,8278,8278,22,52196,0,38.9,55.9,0.0,0.1,0.3,0.8,3.5,20684,29786,69,168,432,1879
E14000646,CONGLETON,49950,49731,95.0,57.8,52.7,48.8,48.8,0.1,0.3,0.8,4.6,0.1,98.8,47440,28861,26325,58,165,376,2291,24392,24392,59,49366,0,42.3,52.7,0.0,0.1,0.2,0.4,3.8,21115,26325,58,107,211,1915
E14000647,COPELAND,42227,41984,93.5,2.1,2.1,2.1,2.1,0.5,1.1,1.9,5.9,1.5,98.7,39481,907,907,203,468,819,2503,907,907,626,41663,0,91.3,2.1,0.0,0.5,0.6,0.8,4.0,38574,907,203,265,351,1684
E14000648,CORBY,57486,57212,98.1,67.6,66.7,24.2,66.7,0.1,0.3,0.4,1.4,0.4,98.9,56388,38862,38355,33,152,211,824,13934,38353,207,56833,0,31.4,66.7,0.0,0.1,0.2,0.1,1.1,18033,38355,33,119,59,613
E14000649,COVENTRY NORTH EAST,53404,53175,98.8,97.2,97.2,95.3,97.2,0.0,0.1,0.4,0.7,0.0,98.9,52786,51919,51896,3,56,206,389,50902,51896,6,52801,0,1.7,97.2,0.0,0.0,0.1,0.3,0.3,890,51896,3,53,150,183
E14000650,COVENTRY NORTH WEST,47412,47237,99.1,95.4,95.1,91.4,95.1,0.0,0.1,0.2,0.5,0.0,99.2,46985,45212,45078,1,60,99,252,43333,45078,5,47026,0,4.0,95.1,0.0,0.0,0.1,0.1,0.3,1907,45078,1,59,39,153
E14000651,COVENTRY SOUTH,48216,48030,97.0,90.3,89.7,87.4,89.7,0.0,0.6,0.8,2.6,0.0,97.1,46760,43521,43263,0,298,377,1270,42145,43267,0,46817,0,7.3,89.7,0.0,0.0,0.6,0.2,1.9,3497,43263,0,298,79,893
E14000652,CRAWLEY,49420,49344,98.7,85.8,84.8,6.7,6.8,0.0,0.1,0.3,1.1,0.0,99.3,48785,42394,41894,6,45,132,559,3327,3343,5,49053,0,13.9,84.8,0.0,0.0,0.1,0.2,0.9,6891,41894,6,39,87,427
E14000653,CREWE AND NANTWICH,54034,53766,96.0,29.6,15.8,6.2,6.2,0.0,0.2,0.5,3.5,0.2,98.9,51884,16008,8541,12,106,281,1882,3370,3370,95,53434,1071,80.2,15.8,2.0,0.0,0.2,0.3,3.0,43343,8541,12,94,175,1601
E14000654,CROYDON CENTRAL,56239,55844,96.5,84.4,82.5,22.0,82.9,0.0,0.0,0.1,2.8,0.0,97.1,54273,47473,46412,1,6,43,1571,12358,46609,11,54619,0,14.0,82.5,0.0,0.0,0.0,0.1,2.7,7861,46412,1,5,37,1528
E14000655,CROYDON NORTH,62070,61844,95.8,88.8,87.9,42.8,87.9,0.0,0.0,0.4,3.9,0.0,95.9,59447,55113,54553,0,31,238,2397,26560,54553,12,59531,0,7.9,87.9,0.0,0.0,0.0,0.3,3.5,4894,54553,0,31,207,2159
E14000656,CROYDON SOUTH,50882,50669,95.4,81.5,81.2,16.8,80.6,0.0,0.1,0.4,4.1,0.0,96.6,48564,41486,41319,0,53,222,2105,8538,41003,2,49130,0,14.2,81.2,0.0,0.0,0.1,0.3,3.7,7245,41319,0,53,169,1883
E14000657,DAGENHAM AND RAINHAM,46315,46072,96.7,87.8,87.1,35.2,85.2,0.0,0.4,0.9,2.8,0.5,97.1,44774,40677,40350,21,183,415,1298,16304,39461,242,44985,0,9.6,87.1,0.0,0.0,0.3,0.5,1.9,4424,40350,21,162,232,883
E14000658,DARLINGTON,47635,47537,98.1,90.7,90.4,1.8,1.8,0.1,0.7,1.0,1.7,0.0,98.3,46748,43211,43047,64,347,483,789,853,868,4,46837,4300,7.8,90.4,9.0,0.1,0.6,0.3,0.6,3701,43047,64,283,136,306
E14000659,DARTFORD,52773,52686,96.5,73.4,71.7,39.6,70.2,0.3,0.6,0.9,3.4,0.0,98.6,50906,38738,37843,142,312,495,1780,20903,37069,12,52043,0,24.8,71.7,0.0,0.3,0.3,0.3,2.4,13063,37843,142,170,183,1285
E14000660,DAVENTRY,46841,46645,95.9,54.0,49.4,41.0,46.4,0.4,0.8,1.4,3.7,0.2,98.0,44912,25307,23155,170,366,673,1733,19198,21756,107,45924,350,46.4,49.4,0.7,0.4,0.4,0.7,2.3,21757,23155,170,196,307,1060
E14000661,DENTON AND REDDISH,43973,43735,98.1,88.2,86.8,13.3,45.5,0.0,0.1,0.2,1.4,0.0,98.9,43138,38786,38148,0,51,88,597,5859,20006,2,43503,0,11.3,86.8,0.0,0.0,0.1,0.1,1.2,4990,38148,0,51,37,509
E14000662,DERBY NORTH,48890,48757,99.3,95.4,94.9,57.5,57.6,0.0,0.0,0.2,0.4,0.0,99.5,48559,46645,46381,2,19,89,198,28103,28142,0,48645,0,4.5,94.9,0.0,0.0,0.0,0.1,0.2,2178,46381,2,17,70,109
E14000663,DERBY SOUTH,52385,52161,97.7,92.8,91.8,41.7,41.7,0.0,0.0,0.1,1.8,0.0,97.8,51205,48627,48097,10,14,71,956,21843,21843,0,51255,0,5.9,91.8,0.0,0.0,0.0,0.1,1.7,3108,48097,10,4,57,885
E14000664,DERBYSHIRE DALES,41990,41664,89.2,12.5,12.5,12.2,12.2,0.6,1.9,3.6,10.1,1.4,96.4,37438,5261,5229,244,795,1527,4226,5120,5120,606,40499,0,76.7,12.5,0.0,0.6,1.3,1.7,6.4,32209,5229,244,551,732,2699
E14000665,DEVIZES,45885,45672,93.1,27.1,27.1,10.1,27.1,0.2,0.9,2.0,6.5,0.9,98.5,42697,12421,12418,73,404,920,2975,4617,12417,416,45187,0,66.0,27.1,0.0,0.2,0.7,1.1,4.5,30279,12418,73,331,516,2055
E14000666,DEWSBURY,48942,48740,97.3,76.3,76.3,31.8,31.8,0.0,0.1,0.2,2.2,0.0,98.7,47639,37346,37331,5,44,110,1101,15575,15575,1,48298,0,21.1,76.3,0.0,0.0,0.1,0.1,2.0,10308,37331,5,39,66,991
E14000667,DON VALLEY,47331,47112,96.9,47.9,47.9,34.5,34.5,0.0,0.2,0.8,2.7,0.1,98.6,45842,22675,22653,22,104,379,1270,16317,16317,32,46677,12120,49.0,47.9,25.6,0.0,0.2,0.6,1.9,23189,22653,22,82,275,891
E14000668,DONCASTER CENTRAL,52722,52384,98.2,81.8,81.7,73.6,73.6,0.0,0.1,0.3,1.2,0.0,98.4,51753,43114,43094,6,64,161,631,38819,38819,23,51898,16735,16.4,81.7,31.7,0.0,0.1,0.2,0.9,8659,43094,6,58,97,470
E14000669,DONCASTER NORTH,47328,47186,97.6,60.0,59.6,37.1,37.1,0.2,0.4,0.5,2.1,0.1,99.3,46187,28413,28199,73,185,244,999,17575,17575,27,46996,4413,38.0,59.6,9.3,0.2,0.2,0.1,1.6,17988,28199,73,112,59,755
E14000670,DOVER,48883,48625,94.4,51.1,51.1,21.2,21.2,0.3,0.6,1.0,5.0,0.2,98.4,46165,24982,24979,141,271,513,2460,10351,10351,92,48105,14541,43.3,51.1,29.7,0.3,0.3,0.5,4.0,21186,24979,141,130,242,1947
E14000671,DUDLEY NORTH,38062,37954,98.8,89.9,88.8,1.2,87.2,0.0,0.0,0.0,0.9,0.0,99.2,37605,34232,33782,0,0,14,349,442,33173,0,37755,2524,10.0,88.8,6.6,0.0,0.0,0.0,0.9,3823,33782,0,0,14,335
E14000672,DUDLEY SOUTH,38698,38543,98.7,89.7,87.9,1.8,86.3,0.0,0.0,0.1,0.9,0.0,98.9,38177,34698,34009,0,7,36,366,688,33391,17,38261,3794,10.8,87.9,9.8,0.0,0.0,0.1,0.9,4168,34009,0,7,29,330
E14000673,DULWICH AND WEST NORWOOD,52507,52230,97.1,82.3,80.3,19.7,79.2,0.0,0.0,0.0,2.4,0.0,97.1,50968,43234,42155,0,0,0,1262,10363,41567,1,50996,0,16.8,80.3,0.0,0.0,0.0,0.0,2.4,8813,42155,0,0,0,1262
E14000674,EALING CENTRAL AND ACTON,61693,61207,97.0,83.0,80.8,10.4,80.5,0.0,0.1,0.8,2.3,0.0,97.0,59817,51193,49848,0,57,489,1390,6433,49636,17,59825,0,16.2,80.8,0.0,0.0,0.1,0.7,1.5,9969,49848,0,57,432,901
E14000675,EALING NORTH,49370,48996,98.1,87.9,85.2,22.2,86.0,0.0,0.1,0.8,1.1,0.0,98.2,48447,43395,42071,3,51,380,549,10938,42440,0,48463,0,12.9,85.2,0.0,0.0,0.1,0.7,0.3,6376,42071,3,48,329,169
E14000676,"EALING, SOUTHALL",39019,38619,96.6,47.2,46.1,17.5,46.1,0.0,0.1,0.5,2.4,0.1,96.6,37698,18419,17982,0,27,200,921,6819,17976,22,37701,0,50.5,46.1,0.0,0.0,0.1,0.4,1.8,19716,17982,0,27,173,721
E14000677,EASINGTON,41375,41294,97.4,73.8,70.4,66.7,66.7,0.0,0.2,0.3,2.4,0.0,99.7,40318,30521,29126,18,63,129,976,27589,27589,14,41240,0,27.1,70.4,0.0,0.0,0.1,0.2,2.0,11192,29126,18,45,66,847
E14000678,EAST DEVON,55011,54717,92.6,55.1,53.9,48.5,48.5,0.5,1.3,2.3,6.9,0.3,97.4,50936,30307,29665,255,705,1263,3781,26667,26667,161,53601,14492,38.7,53.9,26.3,0.5,0.8,1.0,4.6,21271,29665,255,450,558,2518
E14000679,EAST HAM,56666,56500,97.8,87.8,84.7,66.6,81.4,0.0,0.2,0.7,1.9,0.0,97.8,55408,49749,47997,11,139,424,1092,37727,46110,22,55415,0,13.1,84.7,0.0,0.0,0.2,0.5,1.2,7411,47997,11,128,285,668
E14000680,EAST HAMPSHIRE,48159,47543,91.6,43.6,40.8,23.1,23.1,0.2,0.5,1.3,7.1,0.6,96.2,44114,21020,19631,74,242,603,3429,11125,11125,270,46346,0,50.8,40.8,0.0,0.2,0.3,0.7,5.9,24483,19631,74,168,361,2826
E14000681,EAST SURREY,50133,49887,94.5,63.5,62.2,16.3,16.3,0.1,0.5,0.9,5.0,0.2,99.1,47378,31840,31201,51,252,456,2509,8150,8167,95,49688,0,32.3,62.2,0.0,0.1,0.4,0.4,4.1,16177,31201,51,201,204,2053
E14000682,EAST WORTHING AND SHOREHAM,45385,45265,98.8,89.1,88.9,29.3,29.3,0.0,0.0,0.1,0.9,0.0,99.4,44838,40423,40343,4,13,41,427,13315,13315,9,45119,0,9.9,88.9,0.0,0.0,0.0,0.1,0.9,4495,40343,4,9,28,386
E14000683,EAST YORKSHIRE,53289,53078,94.9,57.7,55.5,54.0,54.0,0.6,1.2,2.0,4.7,0.3,98.8,50579,30738,29599,305,666,1074,2499,28769,28770,157,52670,23175,39.4,55.5,43.5,0.6,0.7,0.8,2.7,20980,29599,305,361,408,1425
E14000684,EASTBOURNE,54736,54563,98.9,21.2,21.2,21.2,21.2,0.0,0.0,0.1,0.8,0.0,99.4,54142,11579,11579,1,13,53,421,11579,11579,3,54409,0,77.8,21.2,0.0,0.0,0.0,0.1,0.7,42563,11579,1,12,40,368
E14000685,EASTLEIGH,51936,51714,96.8,75.9,72.5,18.8,28.9,0.0,0.0,0.2,2.7,0.0,98.5,50286,39401,37675,1,10,103,1428,9771,14997,5,51178,0,24.3,72.5,0.0,0.0,0.0,0.2,2.6,12611,37675,1,9,93,1325
E14000686,EDDISBURY,44863,44602,89.7,58.6,57.1,56.2,56.2,0.7,2.4,4.0,9.7,0.7,97.4,40254,26312,25609,327,1077,1790,4348,25204,25204,325,43699,2430,32.6,57.1,5.4,0.7,1.7,1.6,5.7,14645,25609,327,750,713,2558
E14000687,EDMONTON,45404,45062,96.7,89.4,88.5,3.6,88.3,0.0,0.2,1.3,2.6,0.0,96.7,43902,40596,40192,0,86,594,1160,1619,40112,0,43927,0,8.2,88.5,0.0,0.0,0.2,1.1,1.2,3710,40192,0,86,508,566
E14000688,ELLESMERE PORT AND NESTON,44252,44150,97.7,71.8,71.4,21.3,21.3,0.1,0.2,0.2,2.1,0.0,99.1,43214,31792,31589,25,69,102,936,9441,9441,14,43870,0,26.3,71.4,0.0,0.1,0.1,0.1,1.9,11625,31589,25,44,33,834
E14000689,ELMET AND ROTHWELL,48752,48539,94.5,65.4,64.2,49.5,63.2,0.1,0.6,1.2,5.1,0.5,97.2,46057,31908,31287,54,290,604,2482,24113,30794,224,47389,2282,30.3,64.2,4.7,0.1,0.5,0.6,3.9,14770,31287,54,236,314,1878
E14000690,ELTHAM,40879,40814,99.2,86.7,83.5,9.2,81.1,0.0,0.0,0.0,0.7,0.0,99.3,40533,35448,34149,0,10,16,281,3756,33154,0,40607,0,15.6,83.5,0.0,0.0,0.0,0.0,0.6,6384,34149,0,10,6,265
E14000691,ENFIELD NORTH,44861,44464,97.0,90.1,89.2,4.6,88.7,0.1,0.2,0.9,2.1,0.0,97.5,43521,40399,40032,28,110,390,943,2076,39807,1,43723,0,7.8,89.2,0.0,0.1,0.2,0.6,1.2,3489,40032,28,82,280,553
E14000692,"ENFIELD, SOUTHGATE",43255,42828,97.2,84.4,82.8,2.7,81.6,0.0,0.0,0.1,1.9,0.1,97.8,42026,36516,35822,0,0,57,802,1171,35308,61,42289,0,14.3,82.8,0.0,0.0,0.0,0.1,1.7,6204,35822,0,0,57,745
E14000693,EPPING FOREST,45898,45727,96.9,80.5,78.8,6.0,77.3,0.1,0.4,1.0,2.7,0.2,98.6,44486,36949,36159,43,181,444,1241,2774,35493,77,45273,2,18.1,78.8,0.0,0.1,0.3,0.6,1.7,8327,36159,43,138,263,797
E14000694,EPSOM AND EWELL,46081,45995,99.2,88.4,88.3,61.3,61.4,0.0,0.1,0.1,0.6,0.1,99.6,45709,40730,40671,0,52,61,286,28246,28276,41,45905,0,10.9,88.3,0.0,0.0,0.1,0.0,0.5,5038,40671,0,52,9,225
E14000695,EREWASH,47551,47320,98.8,84.5,83.7,33.9,33.9,0.0,0.1,0.1,0.7,0.0,99.4,46966,40160,39814,9,33,64,354,16124,16124,5,47285,0,15.0,83.7,0.0,0.0,0.1,0.1,0.6,7152,39814,9,24,31,290
E14000696,ERITH AND THAMESMEAD,46472,46372,98.5,85.5,84.4,45.9,83.8,0.0,0.2,0.8,1.3,0.0,98.5,45761,39745,39238,1,85,365,611,21351,38957,5,45778,2,14.0,84.4,0.0,0.0,0.2,0.6,0.5,6523,39238,1,84,280,246
E14000697,ESHER AND WALTON,50201,50033,98.5,84.3,82.9,17.9,17.9,0.0,0.0,0.1,1.2,0.0,99.1,49444,42322,41620,1,14,41,589,8962,8970,2,49771,0,15.6,82.9,0.0,0.0,0.0,0.1,1.1,7824,41620,1,13,27,548
E14000698,EXETER,51071,50701,96.3,88.1,87.9,66.1,66.1,0.1,0.2,1.5,3.0,0.0,96.7,49170,44996,44867,33,97,762,1531,33775,33775,9,49381,16334,8.4,87.9,32.0,0.1,0.1,1.3,1.5,4303,44867,33,64,665,769
E14000699,FAREHAM,46351,46237,98.0,85.3,81.8,4.4,4.5,0.1,0.2,0.3,1.8,0.0,99.3,45405,39521,37930,48,77,159,832,2054,2098,2,46030,0,16.1,81.8,0.0,0.1,0.1,0.2,1.5,7475,37930,48,29,82,673
E14000700,FAVERSHAM AND MID KENT,46171,45645,89.7,58.7,57.3,33.9,33.9,0.9,1.9,3.4,9.1,1.0,97.5,41421,27109,26443,404,887,1549,4224,15658,15658,469,45031,9207,32.4,57.3,19.9,0.9,1.0,1.4,5.8,14978,26443,404,483,662,2675
E14000701,FELTHAM AND HESTON,44969,44834,96.5,84.5,84.1,6.4,84.1,0.0,0.2,1.3,3.2,0.8,96.5,43375,37985,37827,0,90,588,1459,2897,37800,370,43416,0,12.3,84.1,0.0,0.0,0.2,1.1,1.9,5548,37827,0,90,498,871
E14000702,FILTON AND BRADLEY STOKE,46355,46109,97.9,82.2,80.6,15.7,80.3,0.0,0.1,0.6,1.6,0.0,98.7,45388,38099,37363,15,40,271,721,7260,37238,20,45742,0,17.3,80.6,0.0,0.0,0.1,0.5,1.0,8025,37363,15,25,231,450
E14000703,FINCHLEY AND GOLDERS GREEN,53242,53033,97.2,62.0,57.1,9.2,53.9,0.0,0.0,0.1,2.5,0.0,98.1,51725,33029,30404,0,13,36,1308,4894,28717,9,52220,0,40.0,57.1,0.0,0.0,0.0,0.0,2.4,21321,30404,0,13,23,1272
E14000704,FOLKESTONE AND HYTHE,57193,56864,92.9,55.8,55.6,25.5,25.5,0.5,1.2,2.6,6.6,0.4,97.6,53106,31910,31817,267,680,1463,3758,14584,14584,243,55842,7943,37.2,55.6,13.9,0.5,0.7,1.4,4.0,21289,31817,267,413,783,2295
E14000705,FOREST OF DEAN,43985,43647,82.5,34.2,32.4,31.3,31.3,0.5,2.7,6.7,16.7,1.7,89.4,36291,15028,14261,236,1208,2957,7356,13761,13761,732,39325,265,50.1,32.4,0.6,0.5,2.2,4.0,10.0,22030,14261,236,972,1749,4399
E14000706,FYLDE,39456,39177,94.1,53.6,45.3,17.2,17.3,0.1,0.3,0.8,5.2,0.0,98.2,37112,21139,17864,28,128,305,2065,6798,6820,7,38763,8537,48.8,45.3,21.6,0.1,0.3,0.4,4.5,19248,17864,28,100,177,1760
E14000707,GAINSBOROUGH,47868,47401,85.5,34.6,32.5,21.1,21.1,2.1,4.5,6.8,13.5,1.6,96.6,40929,16569,15581,1024,2167,3249,6472,10117,10119,763,46224,16577,53.0,32.5,34.6,2.1,2.4,2.3,6.7,25348,15581,1024,1143,1082,3223
E14000708,GARSTON AND HALEWOOD,47135,47080,98.8,82.1,81.9,50.6,81.8,0.0,0.1,0.2,1.1,0.0,99.6,46574,38720,38585,5,26,93,506,23831,38565,1,46936,0,16.9,81.9,0.0,0.0,0.0,0.1,0.9,7989,38585,5,21,67,413
E14000709,GATESHEAD,48595,48429,97.5,88.1,86.1,5.2,5.2,0.0,0.0,0.4,2.1,0.0,97.7,47388,42819,41841,0,14,217,1041,2512,2542,2,47469,0,11.4,86.1,0.0,0.0,0.0,0.4,1.7,5547,41841,0,14,203,824
E14000710,GEDLING,45188,45092,99.5,93.3,92.6,53.3,53.3,0.0,0.1,0.1,0.3,0.0,99.7,44948,42181,41828,5,27,37,144,24095,24095,6,45044,66,6.9,92.6,0.1,0.0,0.0,0.0,0.2,3120,41828,5,22,10,107
E14000711,GILLINGHAM AND RAINHAM,44228,44138,98.4,91.5,90.1,3.1,3.1,0.0,0.1,0.3,1.4,0.0,99.3,43529,40448,39847,0,58,141,609,1375,1375,2,43922,3124,8.3,90.1,7.1,0.0,0.1,0.2,1.1,3682,39847,0,58,83,468
E14000712,GLOUCESTER,56264,56128,98.8,90.2,89.3,20.4,89.4,0.0,0.2,0.3,1.0,0.0,99.2,55574,50759,50250,1,124,182,554,11505,50275,0,55786,2,9.5,89.3,0.0,0.0,0.2,0.1,0.7,5324,50250,1,123,58,372
E14000713,GOSPORT,45372,45331,99.5,87.8,87.6,3.9,3.9,0.0,0.0,0.0,0.4,0.0,99.8,45144,39815,39756,1,9,14,187,1779,1779,0,45303,0,11.9,87.6,0.0,0.0,0.0,0.0,0.4,5388,39756,1,8,5,173
E14000714,GRANTHAM AND STAMFORD,54504,54254,93.0,39.6,38.0,7.3,7.3,1.0,1.4,2.0,6.5,0.3,98.1,50701,21590,20691,536,756,1082,3553,3965,3965,189,53467,2,55.1,38.0,0.0,1.0,0.4,0.6,4.5,30010,20691,536,220,326,2471
E14000715,GRAVESHAM,45524,45239,96.5,77.3,72.4,15.9,15.9,0.1,0.3,0.5,2.8,0.1,98.5,43944,35188,32943,25,131,217,1295,7244,7244,56,44828,0,24.2,72.4,0.0,0.1,0.2,0.2,2.4,11001,32943,25,106,86,1078
E14000716,GREAT GRIMSBY,40733,40670,97.7,90.4,89.7,1.7,1.7,0.0,0.1,0.4,2.1,0.0,98.2,39816,36836,36529,1,38,149,854,698,698,17,39982,11699,8.1,89.7,28.7,0.0,0.1,0.3,1.7,3287,36529,1,37,111,705
E14000717,GREAT YARMOUTH,49254,49039,97.2,56.2,56.2,12.2,12.2,0.0,0.1,0.4,2.4,0.1,99.2,47862,27696,27686,15,59,191,1177,6030,6031,59,48876,0,41.0,56.2,0.0,0.0,0.1,0.3,2.0,20176,27686,15,44,132,986
E14000718,GREENWICH AND WOOLWICH,64532,64022,97.0,78.7,76.4,26.9,75.5,0.0,0.2,0.7,2.3,0.0,97.1,62565,50785,49299,0,135,430,1457,17359,48731,0,62662,0,20.6,76.4,0.0,0.0,0.2,0.5,1.6,13266,49299,0,135,295,1027
E14000719,GUILDFORD,47127,46481,94.3,67.6,65.0,5.9,5.9,0.2,0.6,1.2,4.3,0.3,97.4,44433,31855,30650,110,274,567,2048,2784,2785,129,45917,0,29.2,65.0,0.0,0.2,0.3,0.6,3.1,13783,30650,110,164,293,1481
E14000720,HACKNEY NORTH AND STOKE NEWINGTON,59966,59732,98.1,83.8,80.7,15.8,78.5,0.0,0.0,0.0,1.5,0.0,98.2,58832,50266,48384,0,0,2,900,9452,47050,0,58896,0,17.4,80.7,0.0,0.0,0.0,0.0,1.5,10448,48384,0,0,2,898
E14000721,HACKNEY SOUTH AND SHOREDITCH,66595,65750,95.9,72.4,66.6,41.5,64.6,0.0,0.0,0.3,2.8,0.4,96.0,63885,48217,44340,0,0,221,1865,27670,43001,238,63907,0,29.3,66.6,0.0,0.0,0.0,0.3,2.5,19545,44340,0,0,221,1644
E14000722,HALESOWEN AND ROWLEY REGIS,41822,41693,99.2,92.8,90.9,12.5,89.3,0.0,0.0,0.1,0.5,0.0,99.4,41504,38810,38013,0,5,34,189,5238,37359,0,41563,0,8.3,90.9,0.0,0.0,0.0,0.1,0.4,3491,38013,0,5,29,155
E14000723,HALIFAX,51138,50897,97.4,71.0,70.8,19.0,19.0,0.0,0.1,0.2,2.1,0.0,98.5,49805,36295,36207,3,67,113,1092,9709,9709,1,50386,27,26.6,70.8,0.1,0.0,0.1,0.1,1.9,13598,36207,3,64,46,979
E14000724,HALTEMPRICE AND HOWDEN,42347,41907,96.3,78.3,78.3,78.3,78.3,0.4,0.7,1.1,2.6,0.1,98.4,40795,33143,33143,180,313,451,1112,33142,33143,48,41654,14724,18.1,78.3,34.8,0.4,0.3,0.3,1.6,7652,33143,180,133,138,661
E14000725,HALTON,48075,47571,97.2,68.2,67.6,3.4,4.3,0.0,0.1,0.2,1.8,0.0,98.6,46725,32790,32522,0,28,106,846,1634,2086,0,47405,0,29.5,67.6,0.0,0.0,0.1,0.2,1.5,14203,32522,0,28,78,740
E14000726,HAMMERSMITH,59643,58397,94.4,79.8,72.7,39.6,67.7,0.0,0.1,0.4,3.5,0.3,94.4,56331,47612,43369,2,75,258,2066,23600,40402,164,56319,0,21.7,72.7,0.0,0.0,0.1,0.3,3.0,12962,43369,2,73,183,1808
E14000727,HAMPSTEAD AND KILBURN,66055,65761,98.9,88.9,88.5,56.6,88.7,0.0,0.0,0.0,0.7,0.0,98.9,65320,58696,58461,0,0,3,441,37398,58564,0,65324,3,10.4,88.5,0.0,0.0,0.0,0.0,0.7,6859,58461,0,0,3,438
E14000728,HARBOROUGH,49545,48931,96.8,66.0,61.5,6.7,22.0,0.1,0.1,0.3,1.9,0.1,98.3,47969,32719,30464,28,53,137,962,3323,10893,35,48696,0,35.3,61.5,0.0,0.1,0.1,0.2,1.7,17505,30464,28,25,84,825
E14000729,HARLOW,47167,46974,95.7,89.7,87.6,13.5,13.9,0.1,0.2,1.1,3.9,0.0,96.3,45147,42318,41319,33,72,508,1827,6363,6552,13,45415,251,8.1,87.6,0.5,0.1,0.1,0.9,2.8,3828,41319,33,39,436,1319
E14000730,HARROGATE AND KNARESBOROUGH,51809,51603,96.9,81.1,78.8,37.3,37.3,0.0,0.2,0.4,2.7,0.2,98.2,50227,42011,40824,14,89,205,1376,19324,19325,116,50878,4135,18.1,78.8,8.0,0.0,0.1,0.2,2.3,9403,40824,14,75,116,1171
E14000731,HARROW EAST,40410,40289,98.6,85.8,85.6,22.5,85.6,0.0,0.0,0.4,1.1,0.0,98.8,39854,34662,34595,1,6,176,435,9088,34594,9,39939,0,13.0,85.6,0.0,0.0,0.0,0.4,0.6,5259,34595,1,5,170,259
E14000732,HARROW WEST,46113,45952,97.1,84.0,83.6,9.6,83.5,0.0,0.0,0.3,2.6,0.0,97.1,44757,38714,38566,0,6,116,1195,4409,38482,0,44766,0,13.4,83.6,0.0,0.0,0.0,0.2,2.3,6191,38566,0,6,110,1079
E14000733,HARTLEPOOL,47613,47138,95.7,88.1,88.0,6.0,6.0,0.3,0.5,1.2,3.3,0.1,96.3,45552,41929,41891,141,259,560,1586,2849,2849,51,45831,312,7.7,88.0,0.7,0.3,0.2,0.6,2.2,3661,41891,141,118,301,1026
E14000734,HARWICH AND NORTH ESSEX,45523,44713,93.6,27.7,27.7,27.1,27.1,0.3,1.2,2.0,4.6,0.3,96.2,42604,12600,12591,115,560,924,2109,12316,12316,153,43798,7249,65.9,27.7,15.9,0.3,1.0,0.8,2.6,30013,12591,115,445,364,1185
E14000735,HASTINGS AND RYE,57221,56825,97.2,5.7,5.7,5.7,5.7,0.0,0.1,0.2,2.1,0.0,99.2,55622,3276,3276,25,58,139,1203,3276,3276,18,56767,340,91.5,5.7,0.6,0.0,0.1,0.1,1.9,52346,3276,25,33,81,1064
E14000736,HAVANT,44412,44191,98.6,84.2,84.1,1.8,1.8,0.0,0.1,0.2,0.9,0.0,99.2,43808,37395,37366,1,27,72,383,782,782,4,44056,0,14.5,84.1,0.0,0.0,0.1,0.1,0.7,6442,37366,1,26,45,311
E14000737,HAYES AND HARLINGTON,46170,45487,95.4,87.7,87.4,37.5,87.4,0.1,0.2,1.0,3.1,0.0,95.5,44066,40478,40333,31,81,464,1421,17312,40333,6,44081,0,8.1,87.4,0.0,0.1,0.1,0.8,2.1,3733,40333,31,50,383,957
E14000738,HAZEL GROVE,38259,38103,97.1,85.5,85.4,1.1,1.1,0.1,0.4,0.6,2.5,0.0,98.7,37160,32696,32667,22,155,223,943,413,413,7,37754,4592,11.7,85.4,12.0,0.1,0.3,0.2,1.9,4493,32667,22,133,68,720
E14000739,HEMEL HEMPSTEAD,47775,47577,97.3,84.8,82.0,25.2,25.2,0.2,0.4,0.6,2.3,0.0,98.6,46483,40497,39153,85,200,301,1094,12016,12017,22,47102,0,15.3,82.0,0.0,0.2,0.2,0.2,1.7,7330,39153,85,115,101,793
E14000740,HEMSWORTH,45860,45540,94.1,32.4,31.8,27.0,27.0,0.1,0.4,0.8,5.2,0.2,98.4,43176,14868,14593,33,196,389,2364,12390,12390,98,45120,13397,62.3,31.8,29.2,0.1,0.4,0.4,4.3,28583,14593,33,163,193,1975
E14000741,HENDON,57783,57626,97.6,64.4,63.9,19.9,63.8,0.0,0.0,0.1,2.1,0.0,98.6,56397,37239,36915,0,3,41,1229,11489,36872,1,56961,0,33.7,63.9,0.0,0.0,0.0,0.1,2.1,19482,36915,0,3,38,1188
E14000742,HENLEY,47381,47130,95.3,40.2,34.9,25.8,25.8,0.2,0.5,0.9,4.2,0.3,99.2,45145,19055,16554,81,241,450,1985,12207,12208,141,47002,0,60.3,34.9,0.0,0.2,0.3,0.4,3.2,28591,16554,81,160,209,1535
E14000743,HEREFORD AND SOUTH HEREFORDSHIRE,47969,47576,91.8,23.0,16.6,12.5,12.5,0.9,1.9,3.3,7.4,1.5,97.0,44031,11017,7984,410,915,1572,3545,6003,6003,708,46538,1,75.1,16.6,0.0,0.9,1.1,1.4,4.1,36047,7984,410,505,657,1973
E14000744,HERTFORD AND STORTFORD,52145,51996,96.9,84.1,80.2,11.9,11.9,0.0,0.1,0.2,2.8,0.1,98.2,50539,43875,41800,14,71,122,1457,6193,6193,38,51216,0,16.8,80.2,0.0,0.0,0.1,0.1,2.6,8739,41800,14,57,51,1335
E14000745,HERTSMERE,47003,46763,97.5,83.3,80.9,9.3,9.3,0.0,0.2,0.4,2.0,0.0,98.5,45844,39152,38031,6,90,175,919,4370,4370,2,46303,0,16.6,80.9,0.0,0.0,0.2,0.2,1.6,7813,38031,6,84,85,744
E14000746,HEXHAM,36905,36650,86.5,10.2,8.9,7.7,7.7,2.2,3.7,5.2,12.8,1.5,98.0,31922,3767,3282,801,1359,1902,4728,2853,2854,537,36181,766,77.6,8.9,2.1,2.2,1.5,1.5,7.7,28640,3282,801,558,543,2826
E14000747,HEYWOOD AND MIDDLETON,51372,51191,97.0,69.8,64.6,5.8,5.8,0.0,0.1,0.2,2.7,0.0,98.8,49814,35846,33202,13,47,126,1377,2955,2965,15,50776,0,32.3,64.6,0.0,0.0,0.1,0.2,2.4,16612,33202,13,34,79,1251
E14000748,HIGH PEAK,46313,46002,92.6,11.3,7.8,4.5,4.5,0.4,0.7,1.3,6.7,0.5,98.4,42887,5229,3628,188,346,596,3115,2076,2076,214,45589,0,84.8,7.8,0.0,0.4,0.3,0.5,5.4,39259,3628,188,158,250,2519
E14000749,HITCHIN AND HARPENDEN,45818,45628,95.7,75.5,74.5,18.0,18.0,0.1,0.3,0.7,3.9,0.2,98.0,43830,34612,34134,59,157,328,1798,8256,8256,105,44924,0,21.2,74.5,0.0,0.1,0.2,0.4,3.2,9696,34134,59,98,171,1470
E14000750,HOLBORN AND ST PANCRAS,77392,76270,95.2,90.4,88.2,54.3,88.2,0.0,0.0,0.0,3.3,0.0,95.2,73703,69980,68247,0,0,5,2567,42009,68250,0,73707,0,7.0,88.2,0.0,0.0,0.0,0.0,3.3,5456,68247,0,0,5,2562
E14000751,HORNCHURCH AND UPMINSTER,48326,48109,96.9,84.7,83.3,3.4,82.4,0.1,0.3,0.6,2.6,0.2,98.3,46834,40943,40242,44,139,272,1275,1653,39816,75,47521,0,13.6,83.3,0.0,0.1,0.2,0.3,2.1,6592,40242,44,95,133,1003
E14000752,HORNSEY AND WOOD GREEN,55993,55857,97.8,79.6,77.6,2.0,75.8,0.0,0.0,0.3,2.0,0.0,98.0,54758,44552,43473,0,0,161,1099,1136,42449,0,54860,0,20.2,77.6,0.0,0.0,0.0,0.3,1.7,11285,43473,0,0,161,938
E14000753,HORSHAM,52927,52625,94.3,49.4,43.2,38.1,38.1,0.1,0.6,1.3,5.2,0.5,98.7,49893,26157,22842,59,294,705,2732,20168,20168,270,52263,0,51.1,43.2,0.0,0.1,0.4,0.8,3.8,27051,22842,59,235,411,2027
E14000754,HOUGHTON AND SUNDERLAND SOUTH,44176,43782,95.3,57.9,53.6,17.6,50.9,0.1,0.2,0.7,3.9,0.2,97.6,42079,25579,23669,42,105,301,1703,7759,22494,73,43124,0,41.7,53.6,0.0,0.1,0.1,0.4,3.2,18410,23669,42,63,196,1402
E14000755,HOVE,52631,52402,98.4,86.4,79.9,4.9,4.9,0.0,0.0,0.2,1.2,0.0,98.4,51780,45479,42073,0,8,112,622,2579,2579,0,51803,1,18.4,79.9,0.0,0.0,0.0,0.2,1.0,9707,42073,0,8,104,510
E14000756,HUDDERSFIELD,45780,45669,99.0,92.6,92.5,54.1,54.1,0.0,0.0,0.1,0.8,0.0,99.4,45314,42403,42338,1,17,68,355,24773,24773,8,45493,0,6.5,92.5,0.0,0.0,0.0,0.1,0.6,2976,42338,1,16,51,287
E14000757,HUNTINGDON,57050,56759,97.2,73.6,70.5,11.7,11.7,0.2,0.4,0.9,2.3,0.3,98.8,55453,41994,40225,97,247,516,1306,6655,6655,170,56353,0,26.7,70.5,0.0,0.2,0.3,0.5,1.4,15228,40225,97,150,269,790
E14000758,HYNDBURN,47348,46703,96.4,73.8,68.9,15.3,15.3,0.1,0.1,0.2,2.2,0.0,98.5,45653,34921,32641,24,49,98,1050,7221,7254,1,46621,35197,27.5,68.9,74.3,0.1,0.1,0.1,2.0,13012,32641,24,25,49,952
E14000759,ILFORD NORTH,42048,41813,98.0,89.6,89.2,39.7,89.0,0.0,0.2,0.6,1.4,0.0,98.3,41218,37664,37522,6,93,247,595,16682,37415,0,41327,5,8.8,89.2,0.0,0.0,0.2,0.4,0.8,3696,37522,6,87,154,348
E14000760,ILFORD SOUTH,48610,48373,98.1,87.7,87.5,43.2,87.5,0.0,0.0,0.1,1.5,0.0,98.3,47668,42628,42515,0,0,45,705,21019,42515,0,47772,0,10.6,87.5,0.0,0.0,0.0,0.1,1.4,5153,42515,0,0,45,660
E14000761,IPSWICH,54550,54326,97.9,87.0,83.9,16.1,16.1,0.0,0.1,0.4,1.7,0.0,98.1,53424,47453,45791,0,40,237,902,8784,8785,4,53527,0,14.0,83.9,0.0,0.0,0.1,0.4,1.2,7633,45791,0,40,197,665
E14000762,ISLE OF WIGHT,78495,77985,93.0,35.6,35.6,35.6,35.6,0.3,0.7,1.3,6.3,0.3,99.1,73029,27940,27940,203,530,998,4956,27940,27940,234,77790,0,57.4,35.6,0.0,0.3,0.4,0.6,5.0,45089,27940,203,327,468,3958
E14000763,ISLINGTON NORTH,55317,55210,97.3,91.6,91.4,14.8,91.4,0.0,0.0,0.1,2.5,0.0,97.4,53844,50694,50555,0,0,58,1366,8171,50556,0,53853,0,5.9,91.4,0.0,0.0,0.0,0.1,2.4,3289,50555,0,0,58,1308
E14000764,ISLINGTON SOUTH AND FINSBURY,63720,63223,93.9,78.1,77.1,44.2,77.0,0.0,0.0,0.0,5.4,0.0,93.9,59811,49771,49108,0,0,11,3412,28196,49091,1,59811,0,16.8,77.1,0.0,0.0,0.0,0.0,5.3,10703,49108,0,0,11,3401
E14000765,JARROW,41368,41329,97.0,74.1,73.7,2.4,55.7,0.1,0.6,0.9,2.9,0.0,98.4,40122,30655,30482,38,233,383,1207,973,23029,6,40714,0,23.3,73.7,0.0,0.1,0.5,0.4,2.0,9640,30482,38,195,150,824
E14000766,KEIGHLEY,44250,44154,95.0,78.0,74.4,2.9,72.1,0.2,0.4,0.9,4.8,0.0,98.1,42021,34517,32929,100,183,402,2133,1294,31910,17,43406,33246,20.5,74.4,75.1,0.2,0.2,0.5,3.9,9092,32929,100,83,219,1731
E14000767,KENILWORTH AND SOUTHAM,41904,41665,94.4,55.6,49.5,17.5,46.0,0.5,1.1,1.7,5.1,0.4,98.1,39543,23288,20729,202,453,709,2122,7332,19282,168,41116,39,44.9,49.5,0.1,0.5,0.6,0.6,3.4,18814,20729,202,251,256,1413
E14000768,KENSINGTON,71509,71366,96.8,90.8,87.0,40.2,84.2,0.0,0.0,0.1,3.0,0.0,96.7,69185,64941,62199,0,0,51,2181,28760,60210,13,69184,0,9.8,87.0,0.0,0.0,0.0,0.1,3.0,6986,62199,0,0,51,2130
E14000769,KETTERING,48949,48599,97.6,81.7,81.1,16.6,81.1,0.1,0.3,0.6,1.7,0.2,98.2,47764,39971,39675,38,150,274,835,8143,39675,84,48073,0,16.5,81.1,0.0,0.1,0.2,0.3,1.1,8089,39675,38,112,124,561
E14000770,KINGSTON AND SURBITON,52938,52716,97.8,92.3,88.7,3.3,86.5,0.0,0.0,0.1,1.8,0.0,98.0,51762,48855,46965,0,2,78,954,1765,45790,4,51856,0,9.1,88.7,0.0,0.0,0.0,0.1,1.7,4797,46965,0,2,76,876
E14000771,KINGSTON UPON HULL EAST,43744,43298,98.9,97.5,97.5,97.5,97.5,0.0,0.0,0.1,0.1,0.0,98.9,43273,42670,42670,0,1,24,25,42670,42670,1,43273,22160,1.4,97.5,50.7,0.0,0.0,0.1,0.0,603,42670,0,1,23,1
E14000772,KINGSTON UPON HULL NORTH,44862,43971,98.0,97.8,97.8,97.8,97.8,0.0,0.0,0.0,0.0,0.0,98.0,43967,43877,43877,0,0,0,4,43877,43877,0,43967,13471,0.2,97.8,30.0,0.0,0.0,0.0,0.0,90,43877,0,0,0,4
E14000773,KINGSTON UPON HULL WEST AND HESSLE,48125,47448,98.6,97.6,97.6,97.6,97.6,0.0,0.0,0.0,0.0,0.0,98.6,47429,46978,46978,1,1,4,19,46978,46978,2,47429,24523,0.9,97.6,51.0,0.0,0.0,0.0,0.0,451,46978,1,0,3,15
E14000774,KINGSWOOD,40323,40216,99.0,87.9,86.8,7.9,86.6,0.0,0.0,0.1,0.7,0.0,99.5,39938,35460,35017,1,3,30,278,3183,34912,3,40121,0,12.2,86.8,0.0,0.0,0.0,0.1,0.6,4921,35017,1,2,27,248
E14000775,KNOWSLEY,53340,53151,98.4,82.4,82.0,27.3,81.9,0.0,0.1,0.2,1.3,0.1,99.2,52479,43966,43747,8,76,111,672,14576,43660,28,52891,4155,16.4,82.0,7.8,0.0,0.1,0.1,1.1,8732,43747,8,68,35,561
E14000776,LANCASTER AND FLEETWOOD,41681,41445,96.3,61.9,56.8,45.2,45.2,0.2,0.4,0.8,3.1,0.1,98.7,40148,25794,23689,94,174,334,1297,18839,18839,25,41159,513,39.5,56.8,1.2,0.2,0.2,0.4,2.3,16459,23689,94,80,160,963
E14000777,LEEDS CENTRAL,76505,75777,92.1,88.3,85.1,58.3,84.2,0.0,0.2,0.3,6.9,0.0,92.1,70474,67525,65073,0,133,240,5303,44567,64455,0,70485,13605,7.1,85.1,17.8,0.0,0.2,0.1,6.6,5401,65073,0,133,107,5063
E14000778,LEEDS EAST,46227,46120,98.6,95.0,95.0,62.0,95.0,0.0,0.2,0.6,1.2,0.1,98.7,45564,43917,43898,0,87,289,556,28645,43899,27,45610,6927,3.6,95.0,15.0,0.0,0.2,0.4,0.6,1666,43898,0,87,202,267
E14000779,LEEDS NORTH EAST,42610,42544,98.6,94.3,94.1,72.7,94.1,0.0,0.0,0.3,1.2,0.0,99.0,42033,40169,40093,2,4,124,511,30972,40088,2,42199,3665,4.6,94.1,8.6,0.0,0.0,0.3,0.9,1940,40093,2,2,120,387
E14000780,LEEDS NORTH WEST,38400,38320,97.0,78.5,75.0,34.7,72.6,0.0,0.4,0.6,2.8,0.0,98.0,37241,30139,28817,14,141,232,1079,13317,27887,2,37625,9499,21.9,75.0,24.7,0.0,0.3,0.2,2.2,8424,28817,14,127,91,847
E14000781,LEEDS WEST,47583,47463,98.8,95.1,94.2,64.9,93.4,0.1,0.2,0.3,0.9,0.0,99.1,47023,45251,44833,28,100,134,440,30899,44465,0,47174,2302,4.6,94.2,4.8,0.1,0.2,0.1,0.6,2190,44833,28,72,34,306
E14000782,LEICESTER EAST,45483,45377,99.3,94.7,94.5,59.6,59.6,0.0,0.0,0.0,0.4,0.0,99.7,45178,43084,42964,0,1,9,199,27111,27111,0,45347,0,4.9,94.5,0.0,0.0,0.0,0.0,0.4,2214,42964,0,1,8,190
E14000783,LEICESTER SOUTH,52844,52606,98.1,89.6,87.3,4.5,4.5,0.0,0.0,0.1,1.4,0.0,98.1,51843,47324,46151,0,0,59,763,2378,2378,3,51861,0,10.8,87.3,0.0,0.0,0.0,0.1,1.3,5692,46151,0,0,59,704
E14000784,LEICESTER WEST,47300,47182,99.2,93.5,91.8,11.8,11.8,0.0,0.0,0.1,0.5,0.0,99.3,46939,44246,43430,0,6,30,243,5577,5577,1,46989,0,7.4,91.8,0.0,0.0,0.0,0.1,0.5,3509,43430,0,6,24,213
E14000785,LEIGH,51070,51030,98.4,86.6,86.6,10.6,86.6,0.0,0.1,0.2,1.5,0.0,99.7,50265,44237,44209,20,55,117,765,5417,44206,11,50893,3506,11.9,86.6,6.9,0.0,0.1,0.1,1.3,6056,44209,20,35,62,648
E14000786,LEWES,44164,43962,96.3,17.4,17.3,17.3,17.3,0.1,0.3,0.7,3.2,0.3,99.3,42532,7665,7658,40,138,304,1430,7660,7660,114,43840,0,79.0,17.3,0.0,0.1,0.2,0.4,2.5,34874,7658,40,98,166,1126
E14000787,LEWISHAM EAST,48412,48079,98.5,82.1,79.6,9.3,77.5,0.0,0.0,0.1,0.8,0.0,98.8,47674,39741,38559,0,0,50,405,4513,37515,0,47833,0,18.8,79.6,0.0,0.0,0.0,0.1,0.7,9115,38559,0,0,50,355
E14000788,LEWISHAM WEST AND PENGE,52465,52176,95.2,74.6,74.1,16.2,73.8,0.0,0.0,0.4,4.3,0.0,95.5,49943,39122,38876,0,0,199,2233,8490,38723,0,50125,0,21.1,74.1,0.0,0.0,0.0,0.4,3.9,11067,38876,0,0,199,2034
E14000789,"LEWISHAM, DEPTFORD",62159,60340,92.6,60.7,59.5,26.2,59.5,0.0,0.0,0.1,4.5,0.0,92.6,57557,37718,36999,0,0,56,2783,16295,36966,0,57580,0,33.1,59.5,0.0,0.0,0.0,0.1,4.4,20558,36999,0,0,56,2727
E14000790,LEYTON AND WANSTEAD,42600,42496,96.7,86.4,84.8,14.6,83.6,0.0,0.0,0.6,3.0,0.0,96.7,41199,36814,36125,0,18,244,1297,6232,35604,1,41215,0,11.9,84.8,0.0,0.0,0.0,0.5,2.5,5074,36125,0,18,226,1053
E14000791,LICHFIELD,45934,45721,95.8,69.7,66.7,25.2,64.2,0.2,0.6,1.2,3.7,0.3,99.0,44005,32031,30632,95,296,553,1716,11570,29500,132,45464,0,29.1,66.7,0.0,0.2,0.4,0.6,2.5,13373,30632,95,201,257,1163
E14000792,LINCOLN,54457,54344,97.9,83.2,82.3,3.8,3.8,0.0,0.1,0.5,1.9,0.0,98.3,53329,45285,44845,17,49,286,1015,2070,2070,11,53532,41380,15.6,82.3,76.0,0.0,0.1,0.4,1.3,8484,44845,17,32,237,729
E14000793,"LIVERPOOL, RIVERSIDE",68119,67492,84.8,68.3,61.8,21.8,57.5,0.0,0.0,1.0,14.3,0.0,85.1,57735,46511,42089,1,1,676,9757,14824,39154,0,57943,0,23.0,61.8,0.0,0.0,0.0,1.0,13.3,15646,42089,1,0,675,9081
E14000794,"LIVERPOOL, WALTON",45262,44890,98.2,84.3,83.4,7.7,82.5,0.0,0.1,0.1,0.9,0.0,98.6,44466,38161,37733,0,30,35,424,3496,37338,0,44646,0,14.9,83.4,0.0,0.0,0.1,0.0,0.9,6733,37733,0,30,5,389
E14000795,"LIVERPOOL, WAVERTREE",42207,42136,99.2,94.6,93.2,69.9,92.2,0.0,0.0,0.1,0.6,0.0,99.5,41889,39916,39350,0,7,49,247,29515,38905,6,41987,0,6.0,93.2,0.0,0.0,0.0,0.1,0.5,2539,39350,0,7,42,198
E14000796,"LIVERPOOL, WEST DERBY",42091,42002,99.5,92.2,91.8,48.2,91.6,0.0,0.0,0.0,0.3,0.0,99.7,41887,38816,38657,0,5,20,115,20296,38550,0,41962,0,7.7,91.8,0.0,0.0,0.0,0.0,0.2,3230,38657,0,5,15,95
E14000797,LOUGHBOROUGH,46697,46556,98.5,75.8,71.0,4.9,4.9,0.2,0.3,0.4,1.2,0.0,99.3,45995,35382,33141,78,136,179,561,2287,2287,19,46367,0,27.5,71.0,0.0,0.2,0.1,0.1,0.8,12854,33141,78,58,43,382
E14000798,LOUTH AND HORNCASTLE,51315,51042,88.6,17.9,17.6,5.2,5.2,0.8,2.2,3.9,10.9,1.0,97.6,45462,9177,9037,409,1125,1997,5580,2643,2644,535,50095,10378,71.0,17.6,20.2,0.8,1.4,1.7,7.0,36425,9037,409,716,872,3583
E14000799,LUDLOW,42302,41814,79.3,8.3,8.3,8.3,8.3,1.9,5.7,10.2,19.5,1.4,92.4,33554,3521,3520,823,2417,4311,8260,3520,3520,585,39073,31121,71.0,8.3,73.6,1.9,3.8,4.5,9.3,30034,3520,823,1594,1894,3949
E14000800,LUTON NORTH,39200,39148,99.8,95.9,94.0,1.0,1.0,0.0,0.0,0.0,0.1,0.0,99.8,39110,37594,36860,1,3,3,38,406,406,0,39140,0,5.7,94.0,0.0,0.0,0.0,0.0,0.1,2250,36860,1,2,0,35
E14000801,LUTON SOUTH,50488,50176,97.9,90.5,88.3,7.4,7.4,0.0,0.6,0.7,1.5,0.1,98.3,49411,45711,44584,24,308,369,765,3734,3734,41,49608,0,9.6,88.3,0.0,0.0,0.6,0.1,0.8,4827,44584,24,284,61,396
E14000802,MACCLESFIELD,47300,47056,94.2,68.5,68.5,4.8,4.8,0.2,0.9,1.8,5.2,0.5,97.9,44578,32394,32384,115,444,870,2478,2261,2261,216,46309,2693,25.8,68.5,5.7,0.2,0.7,0.9,3.4,12194,32384,115,329,426,1608
E14000803,MAIDENHEAD,46921,46698,95.4,73.2,68.7,10.7,24.4,0.1,0.3,0.8,4.1,0.1,97.8,44784,34345,32253,38,125,359,1914,5034,11432,54,45906,1320,26.7,68.7,2.8,0.1,0.2,0.5,3.3,12531,32253,38,87,234,1555
E14000804,MAIDSTONE AND THE WEALD,51802,51387,92.7,74.9,69.4,28.8,28.8,0.1,0.7,1.5,6.5,0.3,97.1,48043,38783,35976,29,380,753,3344,14905,14905,142,50298,16412,23.3,69.4,31.7,0.1,0.7,0.7,5.0,12067,35976,29,351,373,2591
E14000805,MAKERFIELD,45166,45141,98.5,85.8,84.5,2.7,83.6,0.0,0.0,0.1,1.4,0.0,99.6,44502,38757,38152,2,10,42,639,1217,37741,2,44993,16459,14.1,84.5,36.4,0.0,0.0,0.1,1.3,6350,38152,2,8,32,597
E14000806,MALDON,42830,42626,93.2,36.0,33.7,31.4,31.4,0.2,0.8,1.7,6.3,0.3,98.5,39937,15418,14440,85,364,712,2689,13441,13441,115,42185,1611,59.5,33.7,3.8,0.2,0.7,0.8,4.6,25497,14440,85,279,348,1977
E14000807,MANCHESTER CENTRAL,82610,79219,86.2,66.6,64.4,45.5,63.4,0.0,0.0,0.8,9.6,0.0,86.5,71249,54980,53171,0,15,663,7970,37606,52405,0,71460,0,21.9,64.4,0.0,0.0,0.0,0.8,8.8,18078,53171,0,15,648,7307
E14000808,"MANCHESTER, GORTON",47298,45631,94.9,72.2,67.0,19.6,60.1,0.0,0.1,0.3,1.6,0.0,94.9,44864,34133,31681,1,49,151,767,9293,28432,0,44907,0,27.9,67.0,0.0,0.0,0.1,0.2,1.3,13183,31681,1,48,102,616
E14000809,"MANCHESTER, WITHINGTON",44105,43977,98.1,89.6,86.1,3.6,82.8,0.0,0.0,0.2,1.6,0.0,98.2,43258,39497,37991,9,9,96,719,1604,36500,0,43317,0,11.9,86.1,0.0,0.0,0.0,0.2,1.4,5267,37991,9,0,87,623
E14000810,MANSFIELD,53280,53105,98.7,88.5,85.9,9.7,9.7,0.0,0.1,0.2,1.0,0.0,99.3,52573,47158,45748,5,35,99,532,5153,5153,16,52904,0,12.8,85.9,0.0,0.0,0.1,0.1,0.8,6825,45748,5,30,64,433
E14000811,MEON VALLEY,44874,44628,92.3,60.9,58.7,8.8,8.8,0.4,1.3,2.3,7.2,0.6,97.1,41404,27337,26327,173,600,1044,3224,3935,3956,288,43565,0,33.6,58.7,0.0,0.4,1.0,1.0,4.9,15077,26327,173,427,444,2180
E14000812,MERIDEN,52382,51827,96.4,84.0,82.8,19.6,82.5,0.1,0.2,0.9,2.5,0.0,97.3,50506,44008,43392,33,125,485,1321,10293,43208,16,50972,0,13.6,82.8,0.0,0.1,0.2,0.7,1.6,7114,43392,33,92,360,836
E14000813,MID BEDFORDSHIRE,54468,53298,94.0,69.7,66.4,30.6,30.8,0.1,0.6,1.2,3.8,0.2,97.1,51209,37960,36165,75,316,669,2089,16680,16762,120,52907,1,27.6,66.4,0.0,0.1,0.4,0.6,2.6,15044,36165,75,241,353,1420
E14000814,MID DERBYSHIRE,39808,39691,97.2,64.4,57.6,20.9,20.9,0.3,0.4,0.5,2.5,0.0,99.2,38682,25656,22916,123,143,182,1009,8304,8304,6,39481,0,39.6,57.6,0.0,0.3,0.1,0.1,2.1,15766,22916,123,20,39,827
E14000815,MID DORSET AND NORTH POOLE,38581,38347,93.8,48.6,48.3,10.9,10.9,0.0,0.2,0.4,5.6,0.2,97.6,36200,18738,18621,13,76,158,2147,4190,4190,84,37662,22,45.6,48.3,0.1,0.0,0.2,0.2,5.2,17579,18621,13,63,82,1989
E14000816,MID NORFOLK,52033,51722,91.6,33.8,33.8,33.8,33.8,0.5,1.4,2.4,7.8,1.3,98.1,47671,17606,17604,254,739,1242,4051,17604,17604,655,51022,2,57.8,33.8,0.0,0.5,0.9,1.0,5.4,30067,17604,254,485,503,2809
E14000817,MID SUSSEX,52593,52287,96.1,48.7,47.2,46.0,46.0,0.0,0.2,0.6,3.3,0.3,98.8,50553,25614,24798,25,122,316,1734,24179,24179,169,51949,0,49.0,47.2,0.0,0.0,0.2,0.4,2.7,25755,24798,25,97,194,1418
E14000818,MID WORCESTERSHIRE,51102,50640,95.0,26.1,21.4,12.5,18.4,0.1,0.6,1.0,4.1,0.3,98.5,48562,13350,10942,69,313,527,2078,6385,9387,149,50321,0,73.6,21.4,0.0,0.1,0.5,0.4,3.0,37620,10942,69,244,214,1551
E14000819,MIDDLESBROUGH,46972,46806,97.2,91.6,91.2,5.6,5.6,0.1,0.5,1.0,2.4,0.0,97.3,45661,43037,42828,64,233,463,1145,2618,2618,14,45715,1110,6.0,91.2,2.4,0.1,0.4,0.5,1.5,2833,42828,64,169,230,682
E14000820,MIDDLESBROUGH SOUTH AND EAST CLEVELAND,46198,46061,95.9,84.4,84.3,6.0,6.0,0.2,0.7,1.5,3.8,0.2,97.8,44316,39003,38959,83,316,684,1745,2791,2791,102,45174,337,11.6,84.3,0.7,0.2,0.5,0.8,2.3,5357,38959,83,233,368,1061
E14000821,MILTON KEYNES NORTH,60645,60319,97.3,85.6,84.5,83.5,83.5,0.1,0.3,1.4,2.2,0.2,98.2,59006,51883,51269,46,161,825,1313,50613,50624,149,59528,1,12.8,84.5,0.0,0.1,0.2,1.1,0.8,7737,51269,46,115,664,488
E14000822,MILTON KEYNES SOUTH,62280,62119,98.7,93.1,91.9,91.2,91.2,0.0,0.3,0.5,1.1,0.1,99.1,61448,57999,57210,25,193,314,671,56815,56815,52,61738,0,6.8,91.9,0.0,0.0,0.3,0.2,0.6,4238,57210,25,168,121,357
E14000823,MITCHAM AND MORDEN,44411,44354,98.8,89.6,87.6,26.4,87.5,0.0,0.0,0.1,1.1,0.0,98.8,43860,39803,38888,0,21,51,494,11704,38879,0,43871,0,11.2,87.6,0.0,0.0,0.0,0.1,1.0,4972,38888,0,21,30,443
E14000824,MOLE VALLEY,43704,43536,93.9,49.9,48.4,11.5,11.5,0.1,0.4,1.0,5.7,0.6,99.1,41031,21823,21153,31,171,457,2505,5014,5014,260,43302,0,45.5,48.4,0.0,0.1,0.3,0.7,4.7,19878,21153,31,140,286,2048
E14000825,MORECAMBE AND LUNESDALE,45145,44962,98.3,68.6,59.6,14.8,14.8,0.1,0.2,0.3,1.3,0.1,99.4,44379,30977,26897,66,83,140,583,6666,6667,34,44882,1171,38.7,59.6,2.6,0.1,0.0,0.1,1.0,17482,26897,66,17,57,443
E14000826,MORLEY AND OUTWOOD,48741,48649,97.7,83.1,81.3,65.2,68.2,0.0,0.3,0.5,2.2,0.0,99.4,47600,40494,39604,9,145,244,1049,31774,33244,6,48431,89,16.4,81.3,0.2,0.0,0.3,0.2,1.7,7996,39604,9,136,99,805
E14000827,NEW FOREST EAST,42567,42350,92.5,37.2,31.7,4.3,4.4,0.4,0.8,1.5,7.0,0.7,98.3,39361,15830,13498,183,329,641,2989,1828,1870,290,41843,0,60.8,31.7,0.0,0.4,0.3,0.7,5.5,25863,13498,183,146,312,2348
E14000828,NEW FOREST WEST,45084,44803,93.7,18.1,18.1,18.0,18.0,0.4,0.7,1.2,5.7,0.7,99.1,42225,8152,8152,193,314,552,2578,8095,8095,294,44690,83,75.6,18.1,0.2,0.4,0.3,0.5,4.5,34073,8152,193,121,238,2026
E14000829,NEWARK,50831,50366,94.6,51.7,50.8,9.5,9.5,0.4,1.2,1.7,4.5,0.3,97.8,48070,26258,25819,193,585,873,2296,4834,4834,133,49712,23277,43.8,50.8,45.8,0.4,0.8,0.6,2.8,22251,25819,193,392,288,1423
E14000830,NEWBURY,51664,51379,97.0,76.2,71.6,34.3,67.9,0.0,0.5,0.7,2.5,0.2,98.1,50091,39343,36968,18,253,361,1288,17723,35075,87,50705,0,25.4,71.6,0.0,0.0,0.5,0.2,1.8,13123,36968,18,235,108,927
E14000831,NEWCASTLE UPON TYNE CENTRAL,47412,47020,94.4,87.3,85.0,45.2,45.2,0.0,0.0,0.1,4.8,0.0,94.5,44765,41395,40320,0,1,59,2255,21412,21414,20,44788,54,9.4,85.0,0.1,0.0,0.0,0.1,4.6,4445,40320,0,1,58,2196
E14000832,NEWCASTLE UPON TYNE EAST,45478,45217,96.8,75.3,70.8,25.5,25.5,0.0,0.0,0.2,2.6,0.0,97.0,44019,34236,32207,4,9,76,1198,11575,11575,0,44130,0,26.0,70.8,0.0,0.0,0.0,0.1,2.5,11812,32207,4,5,67,1122
E14000833,NEWCASTLE UPON TYNE NORTH,46518,46315,97.4,67.1,64.2,36.8,36.8,0.1,0.3,0.4,2.2,0.1,99.2,45295,31194,29867,58,140,184,1020,17123,17125,38,46140,1,33.2,64.2,0.0,0.1,0.2,0.1,1.8,15428,29867,58,82,44,836
E14000834,NEWCASTLE-UNDER-LYME,44478,43708,96.0,74.2,74.2,7.5,7.5,0.0,0.1,0.4,2.3,0.1,97.6,42686,33024,33022,5,52,167,1022,3329,3329,23,43406,76,21.7,74.2,0.2,0.0,0.1,0.3,1.9,9664,33022,5,47,115,855
E14000835,NEWTON ABBOT,46296,46059,92.3,42.8,42.7,7.6,7.6,0.3,1.2,2.0,7.1,0.3,97.9,42753,19820,19773,137,542,927,3306,3522,3522,158,45309,7224,49.6,42.7,15.6,0.3,0.9,0.8,5.1,22980,19773,137,405,385,2379
E14000836,"NORMANTON, PONTEFRACT AND CASTLEFORD",53997,53820,97.2,68.1,68.0,28.4,28.4,0.1,0.4,0.6,2.5,0.0,98.0,52492,36745,36725,36,241,337,1328,15312,15312,21,52916,1537,29.2,68.0,2.8,0.1,0.4,0.2,1.8,15767,36725,36,205,96,991
E14000837,NORTH CORNWALL,51574,50979,86.1,39.9,39.9,39.9,39.9,0.6,1.6,3.4,12.7,1.3,92.4,44420,20571,20570,303,833,1759,6559,20570,20570,672,47673,1433,46.2,39.9,2.8,0.6,1.0,1.8,9.3,23850,20570,303,530,926,4800
E14000838,NORTH DEVON,51857,51373,86.7,27.3,27.3,27.3,27.3,1.5,3.4,6.2,12.4,1.6,93.7,44948,14175,14175,774,1756,3213,6425,14175,14175,841,48603,27286,59.3,27.3,52.6,1.5,1.9,2.8,6.2,30773,14175,774,982,1457,3212
E14000839,NORTH DORSET,45616,45390,91.8,29.2,29.2,29.1,29.1,0.2,0.8,1.6,7.8,0.3,98.9,41853,13310,13309,106,354,739,3537,13282,13283,147,45111,4405,62.6,29.2,9.7,0.2,0.5,0.8,6.1,28544,13309,106,248,385,2798
E14000840,NORTH DURHAM,44268,44112,93.0,26.1,21.5,10.2,10.2,0.0,0.5,1.7,6.6,0.2,97.8,41189,11574,9529,4,218,731,2923,4537,4537,99,43297,100,71.5,21.5,0.2,0.0,0.5,1.2,5.0,31660,9529,4,214,513,2192
E14000841,NORTH EAST BEDFORDSHIRE,55735,54600,94.4,62.0,59.4,22.0,27.3,0.3,0.7,1.2,3.6,0.4,97.3,52610,34550,33082,157,389,660,1990,12258,15231,196,54242,273,35.0,59.4,0.5,0.3,0.4,0.5,2.4,19528,33082,157,232,271,1330
E14000842,NORTH EAST CAMBRIDGESHIRE,56520,56183,95.0,55.5,53.7,28.1,28.1,0.4,1.0,1.5,4.4,0.5,98.4,53691,31368,30335,208,549,844,2492,15909,15909,292,55606,75,41.3,53.7,0.1,0.4,0.6,0.5,2.9,23356,30335,208,341,295,1648
E14000843,NORTH EAST DERBYSHIRE,44880,44667,94.4,43.3,41.1,38.5,38.5,0.3,0.7,1.1,5.2,0.1,99.2,42345,19433,18461,153,325,513,2322,17283,17283,53,44530,0,53.2,41.1,0.0,0.3,0.4,0.4,4.0,23884,18461,153,172,188,1809
E14000844,NORTH EAST HAMPSHIRE,47177,46795,94.2,54.3,54.2,12.6,42.8,0.1,0.6,1.1,5.0,0.3,98.5,44443,25632,25575,64,297,534,2352,5928,20195,150,46453,1,40.0,54.2,0.0,0.1,0.5,0.5,3.9,18868,25575,64,233,237,1818
E14000845,NORTH EAST HERTFORDSHIRE,46546,46322,95.2,61.7,60.5,6.6,6.6,0.2,0.7,1.5,4.3,0.5,97.7,44299,28710,28165,87,308,688,2023,3077,3077,246,45455,50,34.7,60.5,0.1,0.2,0.5,0.8,2.9,16134,28165,87,221,380,1335
E14000846,NORTH EAST SOMERSET,43482,43286,92.7,66.0,61.4,40.5,40.6,0.2,0.4,1.1,6.9,0.3,95.9,40297,28685,26717,98,187,488,2989,17597,17638,131,41708,1,31.2,61.4,0.0,0.2,0.2,0.7,5.8,13580,26717,98,89,301,2501
E14000847,NORTH HEREFORDSHIRE,43081,42691,85.3,41.0,39.2,37.8,37.8,1.0,3.1,5.6,13.8,2.1,93.4,36755,17674,16898,427,1337,2430,5936,16293,16293,921,40251,2583,46.1,39.2,6.0,1.0,2.1,2.5,8.1,19857,16898,427,910,1093,3506
E14000848,NORTH NORFOLK,51232,50840,90.5,6.4,6.4,6.4,6.4,0.5,1.4,2.3,8.7,1.7,97.1,46365,3270,3270,268,697,1195,4475,3263,3263,895,49763,0,84.1,6.4,0.0,0.5,0.8,1.0,6.4,43095,3270,268,429,498,3280
E14000849,NORTH SHROPSHIRE,51440,51127,87.2,15.6,10.1,6.2,6.2,0.7,2.3,4.5,12.2,0.6,97.6,44842,8016,5176,382,1172,2308,6285,3175,3175,285,50198,37332,77.1,10.1,72.6,0.7,1.5,2.2,7.7,39666,5176,382,790,1136,3977
E14000850,NORTH SOMERSET,48501,48339,93.4,65.5,60.5,20.8,20.9,0.2,0.8,1.6,6.3,0.4,96.4,45305,31788,29326,91,404,782,3034,10083,10114,201,46743,0,32.9,60.5,0.0,0.2,0.6,0.8,4.6,15979,29326,91,313,378,2252
E14000851,NORTH SWINDON,53114,53073,95.9,86.1,83.1,47.6,47.6,0.0,1.0,1.6,4.0,0.3,96.2,50931,45740,44162,14,520,863,2142,25281,25281,185,51101,0,12.7,83.1,0.0,0.0,1.0,0.6,2.4,6769,44162,14,506,343,1279
E14000852,NORTH THANET,49828,49550,94.6,32.1,32.1,32.1,32.1,0.0,0.9,1.9,4.9,0.0,98.9,47128,15992,15992,17,439,933,2422,15981,15981,15,49291,11495,62.5,32.1,23.1,0.0,0.8,1.0,3.0,31136,15992,17,422,494,1489
E14000853,NORTH TYNESIDE,53922,53835,98.8,75.2,72.1,31.9,31.9,0.0,0.0,0.3,1.0,0.0,99.5,53291,40553,38868,0,18,164,544,17178,17179,11,53637,0,26.7,72.1,0.0,0.0,0.0,0.3,0.7,14423,38868,0,18,146,380
E14000854,NORTH WARWICKSHIRE,43332,43145,97.0,57.7,56.2,18.8,55.3,0.1,0.5,0.8,2.6,0.1,99.1,42028,24991,24369,54,195,332,1117,8137,23943,39,42940,0,40.8,56.2,0.0,0.1,0.3,0.3,1.8,17659,24369,54,141,137,785
E14000855,NORTH WEST CAMBRIDGESHIRE,64260,63657,96.5,60.8,57.7,43.9,43.9,0.2,0.6,0.9,2.5,0.3,98.6,62030,39096,37098,144,403,562,1627,28191,28191,182,63391,7,38.8,57.7,0.0,0.2,0.4,0.2,1.7,24932,37098,144,259,159,1065
E14000856,NORTH WEST DURHAM,47437,47215,94.1,47.6,45.5,45.2,45.2,0.6,1.0,1.6,5.4,0.4,99.0,44649,22603,21568,271,485,739,2566,21448,21448,184,46978,3,48.7,45.5,0.0,0.6,0.5,0.5,3.9,23081,21568,271,214,254,1827
E14000857,NORTH WEST HAMPSHIRE,51634,51383,93.1,53.5,51.1,19.5,50.5,0.2,0.9,2.1,6.4,0.8,97.4,48072,27643,26368,125,477,1059,3311,10057,26094,390,50274,0,42.0,51.1,0.0,0.2,0.7,1.1,4.4,21704,26368,125,352,582,2252
E14000858,NORTH WEST LEICESTERSHIRE,49148,48960,96.9,70.6,68.8,7.6,7.6,0.1,0.6,1.0,2.8,0.2,99.0,47606,34702,33799,71,307,508,1354,3752,3752,104,48653,0,28.1,68.8,0.0,0.1,0.5,0.4,1.7,13807,33799,71,236,201,846
E14000859,NORTH WEST NORFOLK,52788,52296,92.7,15.7,9.5,5.5,5.5,0.2,0.7,1.4,6.4,0.7,97.7,48925,8312,5005,118,360,761,3371,2903,2903,395,51578,0,83.2,9.5,0.0,0.2,0.5,0.8,4.9,43920,5005,118,242,401,2610
E14000860,NORTH WILTSHIRE,44379,44036,93.5,44.2,42.4,31.9,31.9,0.3,1.1,2.1,5.7,0.4,98.3,41501,19615,18819,121,486,935,2535,14141,14141,182,43614,113,51.1,42.4,0.3,0.3,0.8,1.0,3.6,22682,18819,121,365,449,1600
E14000861,NORTHAMPTON NORTH,40684,40307,98.6,92.9,92.4,18.9,92.4,0.0,0.0,0.1,0.5,0.0,98.6,40109,37792,37595,0,1,30,198,7687,37580,1,40134,0,6.2,92.4,0.0,0.0,0.0,0.1,0.4,2514,37595,0,1,29,168
E14000862,NORTHAMPTON SOUTH,48789,47618,97.0,86.0,85.6,53.1,85.5,0.0,0.0,0.1,0.6,0.0,97.1,47338,41972,41775,0,5,28,280,25907,41732,0,47394,1,11.4,85.6,0.0,0.0,0.0,0.0,0.5,5563,41775,0,5,23,252
E14000863,NORWICH NORTH,40444,40329,98.8,87.5,85.4,4.6,4.6,0.0,0.0,0.1,0.9,0.0,99.5,39971,35375,34543,2,9,29,358,1859,1859,5,40222,0,13.4,85.4,0.0,0.0,0.0,0.0,0.8,5428,34543,2,7,20,329
E14000864,NORWICH SOUTH,42783,42598,98.0,84.6,82.0,24.2,24.2,0.0,0.0,0.6,1.6,0.0,98.4,41921,36201,35101,0,2,240,677,10358,10358,0,42084,0,15.9,82.0,0.0,0.0,0.0,0.6,1.0,6820,35101,0,2,238,437
E14000865,NOTTINGHAM EAST,49287,49035,98.0,92.8,90.6,36.2,36.2,0.0,0.0,0.0,1.5,0.0,98.1,48306,45739,44673,0,0,14,729,17855,17855,0,48364,0,7.4,90.6,0.0,0.0,0.0,0.0,1.5,3633,44673,0,0,14,715
E14000866,NOTTINGHAM NORTH,45394,45308,99.4,95.6,95.1,20.7,20.7,0.0,0.1,0.1,0.4,0.0,99.6,45134,43376,43165,1,35,43,174,9376,9376,0,45226,0,4.3,95.1,0.0,0.0,0.1,0.0,0.3,1969,43165,1,34,8,131
E14000867,NOTTINGHAM SOUTH,49905,49737,96.7,89.4,87.0,40.4,40.4,0.0,0.1,0.6,3.0,0.0,96.8,48262,44591,43425,6,40,291,1475,20163,20163,4,48300,0,9.7,87.0,0.0,0.0,0.1,0.5,2.4,4837,43425,6,34,251,1184
E14000868,NUNEATON,45238,45055,98.7,81.6,80.9,18.5,81.3,0.1,0.4,0.4,0.9,0.0,99.2,44630,36897,36612,43,177,190,425,8348,36765,9,44885,0,17.7,80.9,0.0,0.1,0.3,0.0,0.5,8018,36612,43,134,13,235
E14000869,OLD BEXLEY AND SIDCUP,38422,38276,97.3,71.2,68.7,26.7,67.3,0.0,0.0,0.2,2.3,0.0,98.6,37385,27373,26406,2,17,74,891,10275,25843,0,37901,0,28.6,68.7,0.0,0.0,0.0,0.1,2.1,10979,26406,2,15,57,817
E14000870,OLDHAM EAST AND SADDLEWORTH,45223,45107,96.7,67.7,67.1,5.3,5.3,0.1,0.3,0.5,3.0,0.0,99.4,43750,30622,30341,56,128,208,1357,2380,2380,0,44974,0,29.7,67.1,0.0,0.1,0.2,0.2,2.5,13409,30341,56,72,80,1149
E14000871,OLDHAM WEST AND ROYTON,43411,43289,99.3,90.6,90.6,21.1,21.1,0.0,0.0,0.2,0.4,0.0,99.5,43098,39331,39321,0,0,69,191,9144,9159,1,43207,0,8.7,90.6,0.0,0.0,0.0,0.2,0.3,3777,39321,0,0,69,122
E14000872,ORPINGTON,40283,40165,96.1,89.1,89.0,57.2,89.0,0.1,0.8,1.3,3.6,0.1,97.9,38715,35909,35871,49,307,516,1450,23024,35871,56,39425,0,7.1,89.0,0.0,0.1,0.6,0.5,2.3,2844,35871,49,258,209,934
E14000873,OXFORD EAST,51913,51573,97.0,84.1,78.5,1.6,1.6,0.0,0.1,0.5,2.4,0.0,97.2,50348,43645,40736,0,30,242,1225,832,832,2,50440,0,18.5,78.5,0.0,0.0,0.1,0.4,1.9,9612,40736,0,30,212,983
E14000874,OXFORD WEST AND ABINGDON,49547,49148,97.7,83.4,78.6,6.2,6.2,0.0,0.1,0.1,1.5,0.0,98.5,48403,41319,38942,16,31,74,745,3085,3086,13,48796,0,19.1,78.6,0.0,0.0,0.0,0.1,1.4,9461,38942,16,15,43,671
E14000875,PENDLE,44207,43816,95.5,57.1,56.8,6.2,56.3,0.4,0.9,1.2,3.6,0.2,98.2,42216,25253,25090,169,385,545,1600,2752,24907,93,43421,23422,38.7,56.8,53.0,0.4,0.5,0.4,2.4,17126,25090,169,216,160,1055
E14000876,PENISTONE AND STOCKSBRIDGE,42549,42397,94.8,13.6,12.8,6.8,6.8,0.2,0.5,1.2,4.9,0.0,97.9,40318,5798,5465,79,218,520,2079,2904,2904,15,41636,0,81.9,12.8,0.0,0.2,0.3,0.7,3.7,34853,5465,79,139,302,1559
E14000877,PENRITH AND THE BORDER,45737,45098,81.2,10.4,9.0,7.2,7.2,3.5,6.8,9.5,17.4,2.7,94.5,37147,4776,4128,1597,3091,4353,7951,3278,3278,1257,43204,2635,72.2,9.0,5.8,3.5,3.3,2.8,7.9,33019,4128,1597,1494,1262,3598
E14000878,PETERBOROUGH,55636,55469,98.7,91.4,91.3,88.5,88.5,0.1,0.3,0.5,1.0,0.1,99.4,54890,50863,50823,54,171,280,579,49227,49227,52,55299,0,7.3,91.3,0.0,0.1,0.2,0.2,0.5,4067,50823,54,117,109,299
E14000879,"PLYMOUTH, MOOR VIEW",43793,43707,98.0,88.2,87.6,5.8,5.8,0.0,0.2,0.8,1.8,0.0,98.8,42921,38617,38345,4,68,336,786,2546,2547,9,43266,19187,10.4,87.6,43.8,0.0,0.1,0.6,1.0,4576,38345,4,64,268,450
E14000880,"PLYMOUTH, SUTTON AND DEVONPORT",54771,53855,95.3,87.5,85.3,3.4,3.4,0.0,0.2,1.0,3.0,0.0,95.5,52218,47929,46745,0,85,566,1637,1847,1847,0,52321,10570,10.0,85.3,19.3,0.0,0.2,0.9,2.0,5473,46745,0,85,481,1071
E14000881,POOLE,52372,51922,97.3,73.4,71.1,0.9,0.9,0.0,0.0,0.1,1.9,0.0,98.0,50951,38450,37229,0,3,51,971,450,458,6,51348,73,26.2,71.1,0.1,0.0,0.0,0.1,1.8,13722,37229,0,3,48,920
E14000882,POPLAR AND LIMEHOUSE,81634,81032,95.0,79.6,78.7,69.8,78.1,0.0,0.1,0.6,4.3,0.0,95.0,77529,65021,64221,0,53,470,3503,57009,63727,0,77550,0,16.3,78.7,0.0,0.0,0.1,0.5,3.7,13308,64221,0,53,417,3033
E14000883,PORTSMOUTH NORTH,44209,44139,98.4,95.3,92.9,7.2,7.2,0.0,0.2,0.5,1.5,0.0,98.4,43490,42112,41088,1,102,210,649,3161,3161,1,43522,0,5.4,92.9,0.0,0.0,0.2,0.2,1.0,2402,41088,1,101,108,439
E14000884,PORTSMOUTH SOUTH,51472,51283,96.2,93.4,91.0,38.4,38.4,0.0,0.0,0.2,3.4,0.0,96.4,49519,48096,46864,0,3,89,1764,19773,19773,1,49602,0,5.2,91.0,0.0,0.0,0.0,0.2,3.3,2655,46864,0,3,86,1675
E14000885,PRESTON,45790,45603,97.9,73.4,71.3,2.2,2.2,0.0,0.0,0.1,1.7,0.0,98.7,44810,33623,32670,0,3,64,793,1014,1014,3,45173,29277,26.5,71.3,63.9,0.0,0.0,0.1,1.6,12140,32670,0,3,61,729
E14000886,PUDSEY,44807,44675,98.8,89.1,87.6,69.3,86.4,0.0,0.0,0.1,0.9,0.0,99.5,44258,39918,39246,4,14,43,417,31069,38713,0,44567,9554,11.2,87.6,21.3,0.0,0.0,0.1,0.8,5012,39246,4,10,29,374
E14000887,PUTNEY,46400,46080,97.0,83.0,71.9,41.1,62.1,0.0,0.0,0.2,2.3,0.0,97.0,44991,38491,33384,0,4,82,1089,19088,28812,0,45012,1,25.0,71.9,0.0,0.0,0.0,0.2,2.2,11607,33384,0,4,78,1007
E14000888,RAYLEIGH AND WICKFORD,44314,44089,98.4,39.2,36.9,29.2,29.2,0.0,0.0,0.2,1.1,0.0,99.3,43599,17353,16348,1,20,70,490,12931,12931,16,43996,1,61.5,36.9,0.0,0.0,0.0,0.1,0.9,27251,16348,1,19,50,420
E14000889,READING EAST,52149,51473,96.7,85.3,81.5,6.1,79.2,0.0,0.0,0.1,2.0,0.0,96.9,50432,44493,42511,0,7,29,1041,3157,41289,22,50529,1438,15.2,81.5,2.8,0.0,0.0,0.0,1.9,7921,42511,0,7,22,1012
E14000890,READING WEST,48578,48432,98.8,89.6,86.4,22.6,84.4,0.0,0.2,0.4,0.9,0.0,99.0,47974,43540,41953,9,107,179,458,10985,41011,4,48072,0,12.4,86.4,0.0,0.0,0.2,0.1,0.6,6021,41953,9,98,72,279
E14000891,REDCAR,43726,43561,98.0,92.4,90.9,2.1,2.1,0.1,0.3,0.8,1.6,0.4,98.3,42845,40395,39761,23,138,352,716,930,930,158,42971,22,7.1,90.9,0.1,0.1,0.3,0.5,0.8,3084,39761,23,115,214,364
E14000892,REDDITCH,42348,42095,96.8,77.0,76.3,7.3,76.3,0.1,0.3,0.5,2.6,0.1,98.7,40985,32609,32315,22,109,195,1110,3092,32314,46,41814,0,20.5,76.3,0.0,0.1,0.2,0.2,2.2,8670,32315,22,87,86,915
E14000893,REIGATE,46448,46333,96.7,75.1,74.4,19.0,19.0,0.0,0.2,0.3,3.1,0.1,99.5,44915,34904,34554,18,86,154,1418,8822,8831,34,46221,0,22.3,74.4,0.0,0.0,0.1,0.1,2.7,10361,34554,18,68,68,1264
E14000894,RIBBLE VALLEY,50554,50229,93.1,54.3,53.9,29.5,29.7,0.4,1.3,2.3,6.2,0.4,98.5,47091,27436,27267,223,655,1144,3138,14930,15030,184,49781,33011,39.2,53.9,65.3,0.4,0.9,1.0,3.9,19824,27267,223,432,489,1994
E14000895,RICHMOND (YORKS),53013,52505,87.5,15.2,9.2,5.5,5.5,1.9,3.9,6.1,11.5,2.1,96.8,46394,8041,4868,1006,2093,3231,6111,2921,2921,1115,51293,16934,78.3,9.2,31.9,1.9,2.1,2.1,5.4,41526,4868,1006,1087,1138,2880
E14000896,RICHMOND PARK,54544,54412,97.7,85.8,83.0,14.0,81.4,0.0,0.0,0.2,2.1,0.0,98.0,53275,46778,45280,0,13,127,1137,7637,44382,4,53463,0,14.7,83.0,0.0,0.0,0.0,0.2,1.9,7995,45280,0,13,114,1010
E14000897,ROCHDALE,50261,49976,97.8,72.4,65.8,17.2,17.2,0.0,0.2,0.5,1.6,0.0,99.2,49163,36399,33069,16,86,247,813,8648,8648,16,49835,0,32.0,65.8,0.0,0.0,0.1,0.3,1.1,16094,33069,16,70,161,566
E14000898,ROCHESTER AND STROOD,52379,52068,95.1,73.4,68.2,15.3,15.3,0.1,0.5,1.4,4.3,0.2,97.5,49820,38432,35745,32,253,713,2248,8018,8018,117,51064,341,26.9,68.2,0.7,0.1,0.4,0.9,2.9,14075,35745,32,221,460,1535
E14000899,ROCHFORD AND SOUTHEND EAST,51942,51628,97.1,84.1,80.4,56.9,56.9,0.0,0.1,0.2,2.3,0.0,97.4,50448,43691,41764,1,39,86,1180,29550,29550,20,50582,0,16.7,80.4,0.0,0.0,0.1,0.1,2.1,8684,41764,1,38,47,1094
E14000900,ROMFORD,46158,45856,97.3,87.4,84.4,7.0,82.1,0.0,0.0,0.3,2.0,0.0,97.6,44923,40330,38961,8,9,122,933,3215,37907,15,45040,0,12.9,84.4,0.0,0.0,0.0,0.2,1.8,5962,38961,8,1,113,811
E14000901,ROMSEY AND SOUTHAMPTON NORTH,40475,40334,92.8,69.6,67.6,17.7,57.7,0.2,0.7,1.8,6.8,0.5,98.4,37573,28175,27343,85,271,718,2761,7155,23337,214,39820,0,25.3,67.6,0.0,0.2,0.5,1.1,5.0,10230,27343,85,186,447,2043
E14000902,ROSSENDALE AND DARWEN,48929,48601,94.4,53.9,48.1,9.7,9.7,0.1,0.7,1.1,5.0,0.2,98.4,46165,26397,23559,50,360,528,2436,4739,4744,99,48161,14886,46.2,48.1,30.4,0.1,0.6,0.3,3.9,22606,23559,50,310,168,1908
E14000903,ROTHER VALLEY,45696,45512,97.8,47.8,42.4,16.2,16.2,0.1,0.2,0.4,1.8,0.1,99.3,44678,21863,19390,26,84,200,834,7425,7425,53,45377,566,55.3,42.4,1.2,0.1,0.1,0.3,1.4,25288,19390,26,58,116,634
E14000904,ROTHERHAM,43118,42982,98.1,81.0,80.9,26.5,26.5,0.0,0.0,0.3,1.6,0.0,98.9,42300,34945,34870,1,18,132,682,11446,11446,5,42656,0,17.2,80.9,0.0,0.0,0.0,0.3,1.3,7430,34870,1,17,114,550
E14000905,RUGBY,48604,48435,97.9,74.7,71.2,17.1,68.6,0.2,0.4,0.5,1.8,0.0,99.1,47572,36290,34603,96,179,260,863,8292,33321,11,48179,0,26.7,71.2,0.0,0.2,0.2,0.2,1.2,12969,34603,96,83,81,603
E14000906,"RUISLIP, NORTHWOOD AND PINNER",42811,42596,97.7,79.6,77.3,8.9,75.3,0.0,0.1,0.6,1.8,0.0,98.3,41839,34061,33093,14,47,239,757,3810,32252,3,42076,0,20.4,77.3,0.0,0.0,0.1,0.4,1.2,8746,33093,14,33,192,518
E14000907,RUNNYMEDE AND WEYBRIDGE,49772,49465,96.7,71.0,67.8,6.6,53.5,0.1,0.2,0.6,2.7,0.0,98.0,48114,35341,33724,30,77,318,1351,3270,26647,15,48757,0,28.9,67.8,0.0,0.1,0.1,0.5,2.1,14390,33724,30,47,241,1033
E14000908,RUSHCLIFFE,46682,46510,97.1,78.9,76.1,42.6,42.6,0.2,0.4,0.8,2.5,0.2,99.3,45333,36847,35505,71,181,362,1177,19885,19888,88,46346,1475,21.1,76.1,3.2,0.2,0.2,0.4,1.7,9828,35505,71,110,181,815
E14000909,RUTLAND AND MELTON,50153,49887,91.8,31.9,31.6,8.9,8.9,0.6,1.4,2.5,7.7,1.0,97.7,46039,15974,15862,300,712,1257,3848,4446,4446,503,48975,1429,60.2,31.6,2.8,0.6,0.8,1.1,5.2,30177,15862,300,412,545,2591
E14000910,SAFFRON WALDEN,53156,52692,92.7,49.9,48.3,35.7,35.7,0.3,1.0,2.6,6.5,0.8,96.3,49258,26544,25696,174,521,1357,3434,18969,18969,421,51191,1461,44.3,48.3,2.7,0.3,0.7,1.6,3.9,23562,25696,174,347,836,2077
E14000911,SALFORD AND ECCLES,66712,66320,93.4,79.1,79.0,54.9,79.0,0.0,1.3,3.2,6.0,0.0,93.7,62341,52768,52673,2,856,2106,3979,36649,52673,1,62503,0,14.5,79.0,0.0,0.0,1.3,1.9,2.8,9668,52673,2,854,1250,1873
E14000912,SALISBURY,47523,47367,96.8,71.1,71.1,59.8,65.4,0.1,0.3,0.7,2.8,0.4,99.3,46017,33805,33771,39,163,323,1350,28435,31090,167,47210,64,25.8,71.1,0.1,0.1,0.3,0.3,2.2,12246,33771,39,124,160,1027
E14000913,SCARBOROUGH AND WHITBY,56121,55812,93.4,4.1,4.1,4.1,4.1,0.7,1.2,1.8,6.0,0.9,97.8,52417,2301,2301,379,690,1003,3395,2298,2298,516,54896,589,89.3,4.1,1.0,0.7,0.6,0.6,4.3,50116,2301,379,311,313,2392
E14000914,SCUNTHORPE,42509,42246,97.0,76.3,76.2,6.0,76.2,0.4,0.8,1.1,2.4,0.2,98.5,41246,32431,32410,152,338,478,1000,2557,32411,73,41876,30300,20.8,76.2,71.3,0.4,0.4,0.3,1.2,8836,32410,152,186,140,522
E14000915,SEDGEFIELD,42487,42339,91.2,31.4,25.4,18.1,18.1,0.9,2.1,3.2,8.4,0.4,96.9,38757,13360,10776,379,887,1352,3582,7684,7684,167,41190,1834,65.9,25.4,4.3,0.9,1.2,1.1,5.2,27981,10776,379,508,465,2230
E14000916,SEFTON CENTRAL,39192,39135,98.7,86.6,86.5,75.1,86.5,0.0,0.0,0.2,1.2,0.0,99.7,38684,33930,33919,1,18,90,451,29439,33919,13,39058,12,12.2,86.5,0.0,0.0,0.0,0.2,0.9,4765,33919,1,17,72,361
E14000917,SELBY AND AINSTY,49445,48941,91.7,21.5,21.4,21.2,21.3,0.8,1.5,2.3,7.3,0.6,97.4,45335,10641,10591,390,735,1159,3606,10506,10546,289,48172,15553,70.3,21.4,31.5,0.8,0.7,0.9,4.9,34744,10591,390,345,424,2447
E14000918,SEVENOAKS,43343,43136,95.1,63.7,63.7,40.6,63.7,0.1,0.3,0.8,4.5,0.1,99.2,41201,27601,27593,29,141,364,1935,17614,27588,57,43008,0,31.4,63.7,0.0,0.1,0.3,0.5,3.6,13608,27593,29,112,223,1571
E14000919,SHEFFIELD CENTRAL,58552,57817,91.3,73.0,68.6,28.0,28.0,0.0,0.0,1.2,7.5,0.0,91.4,53438,42725,40152,3,23,710,4379,16376,16377,1,53497,198,22.7,68.6,0.3,0.0,0.0,1.2,6.3,13286,40152,3,20,687,3669
E14000920,SHEFFIELD SOUTH EAST,44735,44577,97.4,57.3,50.7,28.2,28.2,0.0,0.2,0.7,2.3,0.0,98.0,43568,25635,22685,8,77,302,1009,12617,12617,18,43825,0,46.7,50.7,0.0,0.0,0.2,0.5,1.6,20883,22685,8,69,225,707
E14000921,"SHEFFIELD, BRIGHTSIDE AND HILLSBOROUGH",48750,48660,99.0,77.1,76.9,31.5,31.5,0.0,0.1,0.4,0.8,0.0,99.2,48280,37580,37512,0,26,188,380,15380,15380,17,48379,0,22.1,76.9,0.0,0.0,0.1,0.3,0.4,10768,37512,0,26,162,192
E14000922,"SHEFFIELD, HALLAM",39028,38964,97.2,33.9,29.8,14.7,14.7,0.1,0.2,0.3,2.6,0.1,99.6,37936,13233,11614,39,75,109,1028,5743,5743,42,38874,0,67.4,29.8,0.0,0.1,0.1,0.1,2.4,26322,11614,39,36,34,919
E14000923,"SHEFFIELD, HEELEY",45519,45432,98.8,58.6,55.4,8.4,8.4,0.0,0.0,0.0,1.0,0.0,99.4,44966,26667,25229,0,0,7,466,3836,3836,0,45257,0,43.4,55.4,0.0,0.0,0.0,0.0,1.0,19737,25229,0,0,7,459
E14000924,SHERWOOD,48594,48280,96.9,71.3,70.4,20.0,20.0,0.1,0.4,0.7,2.5,0.2,99.2,47085,34627,34218,65,208,353,1195,9713,9714,85,48198,381,26.5,70.4,0.8,0.1,0.3,0.3,1.7,12867,34218,65,143,145,842
E14000925,SHIPLEY,44670,44605,96.4,74.2,70.7,18.7,68.6,0.1,0.2,0.4,3.4,0.0,98.3,43077,33158,31593,30,86,165,1528,8375,30661,8,43909,21092,25.7,70.7,47.2,0.1,0.1,0.2,3.1,11484,31593,30,56,79,1363
E14000926,SHREWSBURY AND ATCHAM,52424,52079,89.1,36.0,25.2,18.5,18.5,0.4,1.6,3.5,10.3,0.3,94.9,46695,18854,13190,230,858,1816,5384,9692,9695,152,49767,45088,63.9,25.2,86.0,0.4,1.2,1.8,6.8,33505,13190,230,628,958,3568
E14000927,SITTINGBOURNE AND SHEPPEY,53642,53290,94.5,59.3,52.8,18.8,18.8,0.2,0.6,1.2,4.8,0.1,98.6,50712,31789,28334,89,306,643,2578,10080,10080,55,52872,17542,41.7,52.8,32.7,0.2,0.4,0.6,3.6,22378,28334,89,217,337,1935
E14000928,SKIPTON AND RIPON,51569,51020,89.0,20.0,16.4,13.2,13.2,1.4,2.8,4.3,9.9,1.1,96.6,45898,10289,8438,720,1437,2197,5122,6812,6825,549,49819,18013,72.6,16.4,34.9,1.4,1.4,1.5,5.7,37460,8438,720,717,760,2925
E14000929,SLEAFORD AND NORTH HYKEHAM,56697,56316,93.1,36.6,35.1,14.2,14.2,0.8,1.6,2.5,6.2,0.6,98.2,52778,20748,19928,475,926,1414,3538,8048,8048,336,55702,15986,57.9,35.1,28.2,0.8,0.8,0.9,3.7,32850,19928,475,451,488,2124
E14000930,SLOUGH,54965,54734,98.7,93.7,91.1,61.8,62.4,0.0,0.1,0.1,0.9,0.0,98.9,54244,51526,50081,7,32,80,490,33965,34305,0,54333,0,7.6,91.1,0.0,0.0,0.0,0.1,0.7,4163,50081,7,25,48,410
E14000931,SOLIHULL,45596,45413,98.2,94.9,93.5,58.2,92.7,0.0,0.0,0.7,1.4,0.0,98.2,44774,43253,42632,0,4,308,639,26535,42283,5,44780,1,4.7,93.5,0.0,0.0,0.0,0.7,0.7,2142,42632,0,4,304,331
E14000932,SOMERTON AND FROME,53632,53139,83.8,32.9,32.0,13.1,13.1,0.7,2.7,6.5,15.3,1.2,93.4,44925,17668,17177,368,1450,3493,8214,7049,7049,622,50084,2140,51.7,32.0,4.0,0.7,2.0,3.8,8.8,27748,17177,368,1082,2043,4721
E14000933,SOUTH BASILDON AND EAST THURROCK,44768,44668,96.9,69.4,66.5,4.2,4.2,0.1,0.4,0.8,2.9,0.2,99.1,43376,31075,29786,27,195,351,1292,1876,1876,98,44349,5,30.4,66.5,0.0,0.1,0.4,0.3,2.1,13590,29786,27,168,156,941
E14000934,SOUTH CAMBRIDGESHIRE,53614,53334,95.9,61.8,60.0,23.5,23.5,0.2,0.5,1.1,3.6,0.3,98.1,51400,33127,32168,104,265,610,1934,12619,12619,166,52602,25,35.9,60.0,0.0,0.2,0.3,0.6,2.5,19232,32168,104,161,345,1324
E14000935,SOUTH DERBYSHIRE,49630,49096,93.9,46.1,42.9,38.6,38.6,0.2,0.8,1.2,5.0,0.7,98.2,46613,22883,21291,123,383,613,2483,19172,19172,368,48740,0,51.0,42.9,0.0,0.2,0.5,0.5,3.8,25322,21291,123,260,230,1870
E14000936,SOUTH DORSET,49985,49367,95.1,6.1,6.1,6.1,6.1,0.2,0.4,0.7,3.7,0.5,98.3,47518,3045,3045,79,186,342,1849,3045,3045,239,49111,5,89.0,6.1,0.0,0.2,0.2,0.3,3.0,44473,3045,79,107,156,1507
E14000937,SOUTH EAST CAMBRIDGESHIRE,54530,53974,95.2,56.3,52.7,23.3,23.3,0.2,0.5,1.2,3.8,0.3,98.3,51916,30715,28745,121,271,657,2058,12693,12696,143,53620,241,42.5,52.7,0.4,0.2,0.3,0.7,2.6,23171,28745,121,150,386,1401
E14000938,SOUTH EAST CORNWALL,48509,48078,88.4,38.3,37.6,24.5,24.5,0.5,1.2,2.4,10.7,0.7,94.8,42892,18579,18252,228,587,1151,5186,11883,11883,343,46004,8562,50.8,37.6,17.7,0.5,0.7,1.2,8.3,24640,18252,228,359,564,4035
E14000939,SOUTH HOLLAND AND THE DEEPINGS,51153,50733,89.2,11.8,8.9,7.1,7.1,0.4,1.5,2.7,9.9,1.1,98.3,45647,6056,4542,216,758,1397,5086,3625,3627,545,50275,439,80.4,8.9,0.9,0.4,1.1,1.2,7.2,41105,4542,216,542,639,3689
E14000940,SOUTH LEICESTERSHIRE,49521,49266,96.3,62.6,58.9,39.3,39.3,0.2,0.4,0.6,3.2,0.1,98.1,47702,30979,29156,91,202,305,1564,19480,19480,43,48572,0,37.5,58.9,0.0,0.2,0.2,0.2,2.5,18546,29156,91,111,103,1259
E14000941,SOUTH NORFOLK,52430,52171,91.0,17.7,16.8,14.8,14.8,0.4,1.4,2.7,8.5,1.6,98.2,47710,9255,8808,205,742,1406,4461,7777,7777,826,51476,0,74.2,16.8,0.0,0.4,1.0,1.3,5.8,38902,8808,205,537,664,3055
E14000942,SOUTH NORTHAMPTONSHIRE,55605,55284,95.2,58.8,53.6,46.7,50.4,0.2,1.5,2.1,4.2,0.5,97.2,52942,32718,29829,105,845,1147,2342,25976,28017,265,54025,50,41.6,53.6,0.1,0.2,1.3,0.5,2.1,23113,29829,105,740,302,1195
E14000943,SOUTH RIBBLE,46153,45969,96.0,68.5,66.8,25.0,25.0,0.1,0.5,1.1,3.6,0.0,98.6,44321,31604,30811,38,243,502,1648,11557,11558,23,45527,15722,29.3,66.8,34.1,0.1,0.4,0.6,2.5,13510,30811,38,205,259,1146
E14000944,SOUTH SHIELDS,42545,42507,98.4,83.2,82.6,1.4,82.5,0.0,0.2,0.3,1.5,0.0,99.0,41867,35395,35143,16,65,141,640,615,35080,1,42104,0,15.8,82.6,0.0,0.0,0.1,0.2,1.2,6724,35143,16,49,76,499
E14000945,SOUTH STAFFORDSHIRE,43036,42859,93.2,41.2,36.5,32.8,33.1,0.2,0.6,1.5,6.4,0.1,98.9,40097,17742,15693,72,271,655,2762,14111,14235,46,42568,2322,56.7,36.5,5.4,0.2,0.5,0.9,4.9,24404,15693,72,199,384,2107
E14000946,SOUTH SUFFOLK,45689,45254,93.4,15.8,15.6,11.7,11.7,0.3,0.7,1.1,5.7,0.4,98.4,42665,7236,7121,146,335,500,2589,5344,5344,198,44945,3489,77.8,15.6,7.6,0.3,0.4,0.4,4.6,35544,7121,146,189,165,2089
E14000947,SOUTH SWINDON,49468,49394,89.9,84.3,81.9,20.7,20.7,0.0,0.6,1.8,10.0,0.6,90.4,44447,41721,40537,24,313,885,4947,10218,10218,295,44741,0,7.9,81.9,0.0,0.0,0.6,1.2,8.2,3910,40537,24,289,572,4062
E14000948,SOUTH THANET,51258,50771,96.4,58.6,58.5,58.5,58.5,0.1,0.4,0.8,2.6,0.1,98.5,49429,30047,29995,48,193,413,1342,29963,29963,35,50489,12184,37.9,58.5,23.8,0.1,0.3,0.4,1.8,19434,29995,48,145,220,929
E14000949,SOUTH WEST BEDFORDSHIRE,53866,51296,93.8,72.1,69.4,10.2,10.2,0.0,0.1,0.2,1.5,0.7,94.7,50513,38830,37366,13,43,119,783,5485,5485,361,51036,0,24.4,69.4,0.0,0.0,0.1,0.1,1.2,13147,37366,13,30,76,664
E14000950,SOUTH WEST DEVON,43895,43742,92.0,73.2,72.2,18.6,18.6,0.2,1.0,3.4,7.7,0.8,96.5,40377,32112,31683,74,422,1492,3365,8176,8176,369,42344,11553,19.8,72.2,26.3,0.2,0.8,2.4,4.3,8694,31683,74,348,1070,1873
E14000951,SOUTH WEST HERTFORDSHIRE,48092,47868,96.1,72.6,71.4,29.4,29.4,0.2,0.3,0.6,3.5,0.1,99.1,46198,34898,34314,76,156,298,1670,14143,14160,59,47660,0,24.7,71.4,0.0,0.2,0.2,0.3,2.9,11884,34314,76,80,142,1372
E14000952,SOUTH WEST NORFOLK,52186,51711,89.8,24.0,21.9,19.5,19.5,0.8,1.9,3.3,9.3,1.6,97.6,46837,12510,11433,442,1006,1731,4874,10182,10182,847,50914,8,67.8,21.9,0.0,0.8,1.1,1.4,6.0,35404,11433,442,564,725,3143
E14000953,SOUTH WEST SURREY,48079,47884,94.7,29.3,25.8,13.7,13.7,0.0,0.2,0.4,4.9,0.3,99.4,45542,14106,12417,24,92,208,2342,6595,6595,140,47775,0,68.9,25.8,0.0,0.0,0.1,0.2,4.4,33125,12417,24,68,116,2134
E14000954,SOUTH WEST WILTSHIRE,49876,49702,95.1,59.7,59.5,11.7,11.7,0.3,0.6,1.1,4.6,0.3,98.4,47412,29758,29663,142,297,531,2290,5841,5848,127,49066,1371,35.6,59.5,2.7,0.3,0.3,0.5,3.5,17749,29663,142,155,234,1759
E14000955,"SOUTHAMPTON, ITCHEN",52278,52153,96.4,90.9,90.1,33.4,87.0,0.0,0.0,0.4,3.4,0.0,96.6,50392,47522,47108,4,17,206,1761,17471,45484,0,50494,0,6.3,90.1,0.0,0.0,0.0,0.4,3.0,3284,47108,4,13,189,1555
E14000956,"SOUTHAMPTON, TEST",50899,50823,99.2,98.2,97.0,79.2,94.6,0.0,0.0,0.2,0.7,0.0,99.2,50484,49974,49372,1,14,112,339,40319,48144,7,50512,0,2.2,97.0,0.0,0.0,0.0,0.2,0.4,1112,49372,1,13,98,227
E14000957,SOUTHEND WEST,43058,42876,98.6,66.7,56.9,20.0,20.0,0.0,0.0,0.0,0.9,0.0,99.1,42468,28700,24500,0,2,6,408,8619,8619,2,42652,162,41.7,56.9,0.4,0.0,0.0,0.0,0.9,17968,24500,0,2,4,402
E14000958,SOUTHPORT,46472,45991,97.4,46.6,30.6,1.5,17.4,0.0,0.0,0.1,1.6,0.1,98.7,45248,21647,14223,0,20,39,743,718,8073,31,45854,313,66.8,30.6,0.7,0.0,0.0,0.0,1.5,31025,14223,0,20,19,704
E14000959,SPELTHORNE,45230,45031,97.0,83.9,82.5,23.3,23.3,0.0,0.0,0.6,2.6,0.0,97.6,43864,37954,37300,0,15,277,1167,10557,10561,2,44163,0,14.5,82.5,0.0,0.0,0.0,0.6,2.0,6564,37300,0,15,262,890
E14000960,ST ALBANS,46289,46091,97.2,86.3,83.7,44.9,44.9,0.0,0.0,0.1,2.4,0.0,98.7,45001,39936,38730,1,4,30,1090,20794,20794,16,45690,0,13.5,83.7,0.0,0.0,0.0,0.1,2.3,6271,38730,1,3,26,1060
E14000961,ST AUSTELL AND NEWQUAY,55048,54354,88.5,37.2,30.9,27.1,27.1,0.1,0.8,1.6,10.2,0.5,93.0,48737,20485,17021,80,425,873,5617,14900,14900,287,51174,1622,57.6,30.9,2.9,0.1,0.6,0.8,8.6,31716,17021,80,345,448,4744
E14000962,ST HELENS NORTH,47406,47299,97.6,82.9,82.7,3.0,82.7,0.1,0.4,0.7,2.2,0.1,99.4,46258,39282,39225,63,206,353,1041,1442,39212,31,47125,17432,14.8,82.7,36.8,0.1,0.3,0.3,1.5,7033,39225,63,143,147,688
E14000963,ST HELENS SOUTH AND WHISTON,52151,51941,96.9,83.1,82.0,9.7,81.8,0.1,0.4,0.8,2.7,0.1,98.0,50527,43345,42745,67,221,405,1414,5045,42652,50,51084,20474,14.9,82.0,39.3,0.1,0.3,0.4,1.9,7782,42745,67,154,184,1009
E14000964,ST IVES,50793,50277,86.5,33.0,33.0,33.0,33.0,0.3,0.8,2.1,12.5,1.0,92.2,43934,16768,16768,136,406,1076,6343,16768,16768,487,46812,272,53.5,33.0,0.5,0.3,0.5,1.3,10.4,27166,16768,136,270,670,5267
E14000965,STAFFORD,47501,47389,95.5,70.3,70.1,8.6,12.2,0.2,0.6,1.3,4.3,0.1,98.6,45354,33398,33292,85,281,627,2035,4072,5802,45,46846,239,25.4,70.1,0.5,0.2,0.4,0.7,3.0,12062,33292,85,196,346,1408
E14000966,STAFFORDSHIRE MOORLANDS,37515,37314,89.4,35.2,33.9,3.5,3.5,0.8,1.9,3.8,10.1,1.3,97.0,33525,13223,12711,294,709,1421,3789,1324,1324,478,36392,0,55.5,33.9,0.0,0.8,1.1,1.9,6.3,20814,12711,294,415,712,2368
E14000967,STALYBRIDGE AND HYDE,48564,48227,95.3,27.3,27.1,18.2,19.3,0.0,0.0,0.2,4.0,0.0,99.1,46274,13238,13143,3,21,93,1953,8830,9361,2,48106,0,68.2,27.1,0.0,0.0,0.0,0.1,3.8,33131,13143,3,18,72,1860
E14000968,STEVENAGE,44504,44298,98.4,84.5,84.3,5.8,5.8,0.0,0.0,0.2,1.1,0.0,99.0,43796,37614,37499,0,22,71,502,2597,2597,2,44039,0,14.1,84.3,0.0,0.0,0.0,0.1,1.0,6297,37499,0,22,49,431
E14000969,STOCKPORT,45070,44463,97.8,84.6,84.4,3.1,38.8,0.0,0.0,0.0,0.8,0.0,97.9,44097,38138,38042,1,4,8,366,1407,17465,0,44131,2242,13.4,84.4,5.0,0.0,0.0,0.0,0.8,6055,38042,1,3,4,358
E14000970,STOCKTON NORTH,45189,45056,95.6,90.7,90.2,7.2,7.2,0.1,0.7,1.7,4.2,0.2,96.5,43179,40965,40739,58,313,747,1877,3253,3253,109,43602,3977,5.4,90.2,8.8,0.1,0.6,1.0,2.5,2440,40739,58,255,434,1130
E14000971,STOCKTON SOUTH,47712,47598,96.3,87.4,86.5,7.8,7.8,0.1,0.6,1.5,3.4,0.1,96.6,45955,41688,41290,24,270,727,1643,3745,3745,42,46075,15789,9.8,86.5,33.1,0.1,0.5,1.0,1.9,4665,41290,24,246,457,916
E14000972,STOKE-ON-TRENT CENTRAL,43162,42990,97.4,87.5,87.5,20.4,20.4,0.0,0.0,0.3,2.2,0.0,97.6,42030,37776,37748,0,16,151,960,8822,8822,12,42139,0,9.9,87.5,0.0,0.0,0.0,0.3,1.9,4282,37748,0,16,135,809
E14000973,STOKE-ON-TRENT NORTH,47486,47275,98.0,88.3,87.0,36.2,36.2,0.0,0.0,0.5,1.5,0.2,98.6,46543,41909,41330,0,14,224,732,17173,17173,113,46838,0,11.0,87.0,0.0,0.0,0.0,0.4,1.1,5213,41330,0,14,210,508
E14000974,STOKE-ON-TRENT SOUTH,42700,42470,97.6,72.3,72.2,15.8,15.8,0.0,0.1,0.1,1.9,0.0,99.1,41676,30857,30846,0,46,61,794,6744,6744,0,42321,0,25.4,72.2,0.0,0.0,0.1,0.0,1.7,10830,30846,0,46,15,733
E14000975,STONE,41432,41122,90.0,29.5,29.5,26.0,26.0,0.4,1.6,2.9,9.3,0.7,97.7,37275,12227,12227,165,644,1201,3847,10777,10777,281,40485,1574,60.5,29.5,3.8,0.4,1.2,1.3,6.4,25048,12227,165,479,557,2646
E14000976,STOURBRIDGE,41692,41547,98.8,91.3,90.5,4.3,89.7,0.0,0.0,0.0,0.9,0.0,99.5,41174,38077,37712,1,5,7,373,1787,37390,0,41499,167,8.3,90.5,0.4,0.0,0.0,0.0,0.9,3462,37712,1,4,2,366
E14000977,STRATFORD-ON-AVON,49197,48777,93.9,48.1,45.1,21.9,42.1,0.3,1.0,1.8,5.3,0.6,97.9,46179,23647,22169,169,496,909,2598,10773,20729,305,48172,84,48.8,45.1,0.2,0.3,0.7,0.8,3.4,24010,22169,169,327,413,1689
E14000978,STREATHAM,53524,53283,96.3,74.8,67.3,38.0,61.9,0.0,0.0,0.0,3.3,0.0,96.6,51529,40022,36033,0,0,3,1754,20337,33126,0,51706,0,29.0,67.3,0.0,0.0,0.0,0.0,3.3,15496,36033,0,0,3,1751
E14000979,STRETFORD AND URMSTON,47736,47506,98.2,65.9,64.2,5.0,63.6,0.0,0.1,0.3,1.3,0.0,98.8,46881,31465,30654,4,65,134,625,2373,30360,10,47148,2,34.0,64.2,0.0,0.0,0.1,0.1,1.0,16227,30654,4,61,69,491
E14000980,STROUD,51516,51220,91.7,21.5,21.4,17.4,21.4,0.3,0.9,1.9,7.7,0.3,95.0,47247,11055,11039,132,447,1003,3973,8976,11039,133,48954,72,70.3,21.4,0.1,0.3,0.6,1.1,5.8,36208,11039,132,315,556,2970
E14000981,SUFFOLK COASTAL,57738,56967,92.8,25.2,25.2,13.3,13.3,0.2,0.8,1.5,5.9,0.6,97.3,53581,14553,14525,120,465,883,3386,7702,7702,369,56199,1991,67.6,25.2,3.4,0.2,0.6,0.7,4.3,39056,14525,120,345,418,2503
E14000982,SUNDERLAND CENTRAL,51399,51111,97.0,64.3,60.5,12.5,58.4,0.0,0.0,0.2,2.5,0.0,97.5,49839,33037,31104,1,25,113,1272,6400,30015,1,50105,0,36.5,60.5,0.0,0.0,0.0,0.2,2.3,18735,31104,1,24,88,1159
E14000983,SURREY HEATH,48004,47853,98.0,70.7,70.1,11.2,11.2,0.0,0.0,0.1,1.7,0.0,99.6,47051,33957,33643,1,16,51,802,5363,5367,3,47811,0,27.9,70.1,0.0,0.0,0.0,0.1,1.6,13408,33643,1,15,35,751
E14000984,SUTTON AND CHEAM,44742,44609,98.1,86.8,84.3,8.2,82.8,0.0,0.0,0.0,1.6,0.0,98.1,43886,38839,37721,0,3,5,723,3670,37057,0,43906,0,13.8,84.3,0.0,0.0,0.0,0.0,1.6,6165,37721,0,3,2,718
E14000985,SUTTON COLDFIELD,43574,43487,98.0,86.0,85.2,39.0,84.9,0.0,0.1,0.4,1.8,0.1,98.2,42713,37463,37134,3,41,190,774,17015,36999,53,42788,0,12.8,85.2,0.0,0.0,0.1,0.3,1.3,5579,37134,3,38,149,584
E14000986,TAMWORTH,44304,44130,97.1,77.1,74.0,7.1,71.7,0.2,0.4,0.8,2.5,0.1,99.3,43025,34169,32797,107,166,342,1105,3150,31783,27,44008,0,23.1,74.0,0.0,0.2,0.1,0.4,1.7,10228,32797,107,59,176,763
E14000987,TATTON,42866,42610,92.5,54.0,47.8,8.7,44.1,0.3,0.8,1.7,6.9,0.4,97.9,39640,23135,20487,125,353,717,2970,3749,18902,186,41986,2075,44.7,47.8,4.8,0.3,0.5,0.8,5.3,19153,20487,125,228,364,2253
E14000988,TAUNTON DEANE,58643,58273,89.7,41.7,32.8,25.7,25.7,0.5,1.9,3.8,9.6,1.2,95.9,52629,24469,19218,305,1124,2209,5644,15043,15043,725,56241,18,57.0,32.8,0.0,0.5,1.4,1.9,5.9,33411,19218,305,819,1085,3435
E14000989,TELFORD,46218,45937,98.2,84.8,82.5,12.6,81.3,0.0,0.0,0.1,1.2,0.0,98.6,45376,39180,38136,0,4,64,561,5809,37579,3,45579,19832,15.7,82.5,42.9,0.0,0.0,0.1,1.1,7240,38136,0,4,60,497
E14000990,TEWKESBURY,55100,53942,91.9,63.3,60.3,23.2,58.8,0.2,0.8,1.6,6.0,0.4,93.4,50629,34869,33247,89,447,895,3313,12766,32378,237,51474,7,31.5,60.3,0.0,0.2,0.6,0.8,4.4,17382,33247,89,358,448,2418
E14000991,THE COTSWOLDS,53894,53506,92.7,40.3,40.0,39.9,39.9,0.2,0.7,1.6,6.5,0.8,95.3,49982,21713,21571,89,377,852,3524,21518,21520,430,51354,105,52.7,40.0,0.2,0.2,0.5,0.9,5.0,28411,21571,89,288,475,2672
E14000992,THE WREKIN,44752,44581,95.4,77.0,74.3,9.5,72.2,0.2,0.6,1.4,4.2,0.2,99.0,42687,34471,33261,82,280,614,1894,4272,32304,106,44301,16291,21.1,74.3,36.4,0.2,0.4,0.7,2.9,9426,33261,82,198,334,1280
E14000993,THIRSK AND MALTON,55294,54491,87.7,9.9,9.9,9.9,9.9,1.9,3.7,5.6,10.9,2.3,95.6,48473,5476,5476,1023,2026,3084,6018,5475,5476,1290,52849,16201,77.8,9.9,29.3,1.9,1.8,1.9,5.3,42997,5476,1023,1003,1058,2934
E14000994,THORNBURY AND YATE,40764,40536,97.1,70.8,70.4,17.9,70.4,0.2,0.4,0.8,2.4,0.3,99.1,39577,28875,28696,76,182,321,959,7312,28691,122,40400,1,26.7,70.4,0.0,0.2,0.3,0.3,1.6,10881,28696,76,106,139,638
E14000995,THURROCK,53751,53550,95.9,87.1,85.4,31.8,31.8,0.1,0.4,1.7,3.7,0.1,96.5,51548,46814,45918,31,223,917,2002,17117,17117,36,51887,0,10.5,85.4,0.0,0.1,0.4,1.3,2.0,5630,45918,31,192,694,1085
E14000996,TIVERTON AND HONITON,51455,51087,82.5,16.8,16.8,16.8,16.8,0.9,3.6,6.8,16.8,2.1,93.6,42460,8653,8647,448,1837,3515,8627,8647,8647,1073,48159,260,65.7,16.8,0.5,0.9,2.7,3.3,9.9,33813,8647,448,1389,1678,5112
E14000997,TONBRIDGE AND MALLING,46807,46618,92.5,61.2,60.4,27.4,27.4,0.3,0.7,1.4,7.1,0.5,98.4,43292,28660,28277,123,331,669,3326,12808,12808,223,46059,1519,32.1,60.4,3.2,0.3,0.4,0.7,5.7,15015,28277,123,208,338,2657
E14000998,TOOTING,47702,47312,97.1,84.9,81.2,50.0,78.0,0.0,0.0,0.3,2.1,0.0,97.1,46321,40497,38745,0,0,158,991,23865,37184,0,46332,0,15.9,81.2,0.0,0.0,0.0,0.3,1.7,7576,38745,0,0,158,833
E14000999,TORBAY,58612,58148,95.3,84.1,80.9,44.4,44.4,0.0,0.0,0.2,3.9,0.0,96.5,55849,49264,47409,0,9,97,2299,25995,25995,16,56541,0,14.4,80.9,0.0,0.0,0.0,0.2,3.8,8440,47409,0,9,88,2202
E14001000,TORRIDGE AND WEST DEVON,50878,50401,80.4,14.5,14.5,14.5,14.5,2.0,6.0,10.7,18.7,1.9,93.3,40897,7366,7365,1002,3070,5433,9504,7365,7365,974,47475,27336,65.9,14.5,53.7,2.0,4.1,4.6,8.0,33532,7365,1002,2068,2363,4071
E14001001,TOTNES,50646,50072,85.0,34.0,33.3,28.5,28.5,0.7,2.1,4.8,13.8,1.6,95.2,43058,17202,16881,333,1060,2428,7014,14440,14440,818,48203,5848,51.7,33.3,11.5,0.7,1.4,2.7,9.1,26177,16881,333,727,1368,4586
E14001002,TOTTENHAM,54415,54357,99.0,90.9,90.1,7.8,89.4,0.0,0.0,0.2,0.9,0.0,99.0,53848,49473,49026,0,16,132,509,4221,48663,0,53855,0,8.9,90.1,0.0,0.0,0.0,0.2,0.7,4822,49026,0,16,116,377
E14001003,TRURO AND FALMOUTH,51022,50471,85.2,33.8,33.6,33.4,33.4,0.2,0.6,2.1,13.7,0.8,89.8,43463,17260,17165,90,326,1094,7008,17064,17064,411,45803,683,51.5,33.6,1.3,0.2,0.5,1.5,11.6,26298,17165,90,236,768,5914
E14001004,TUNBRIDGE WELLS,48898,48548,93.3,64.8,61.3,32.9,32.9,0.1,0.8,1.8,6.0,0.6,97.9,45601,31684,29968,37,407,873,2947,16064,16064,279,47878,0,32.0,61.3,0.0,0.1,0.8,1.0,4.2,15633,29968,37,370,466,2074
E14001005,TWICKENHAM,52138,51957,98.6,90.5,89.7,37.6,89.2,0.0,0.0,0.1,1.1,0.0,98.7,51398,47168,46755,0,3,72,559,19585,46532,0,51468,0,8.9,89.7,0.0,0.0,0.0,0.1,0.9,4643,46755,0,3,69,487
E14001006,TYNEMOUTH,48873,48760,99.1,91.1,89.2,42.7,42.7,0.0,0.1,0.2,0.6,0.0,99.3,48451,44532,43589,19,60,117,309,20871,20871,11,48518,1,9.9,89.2,0.0,0.0,0.1,0.1,0.4,4862,43589,19,41,57,192
E14001007,UXBRIDGE AND SOUTH RUISLIP,45877,45264,94.7,83.8,83.2,26.2,83.1,0.0,0.2,0.8,3.9,0.0,94.8,43452,38453,38185,18,110,350,1812,12039,38103,17,43493,0,11.5,83.2,0.0,0.0,0.2,0.5,3.2,5267,38185,18,92,240,1462
E14001008,VAUXHALL,64478,63948,96.7,83.5,81.4,26.7,80.3,0.0,0.0,0.0,2.4,0.0,96.8,62381,53854,52484,0,0,3,1567,17228,51749,2,62416,0,15.3,81.4,0.0,0.0,0.0,0.0,2.4,9897,52484,0,0,3,1564
E14001009,WAKEFIELD,45015,44856,96.5,72.9,72.7,19.1,19.1,0.0,0.0,0.3,3.1,0.0,97.8,43441,32817,32742,0,7,139,1415,8589,8590,3,44014,61,23.8,72.7,0.1,0.0,0.0,0.3,2.8,10699,32742,0,7,132,1276
E14001010,WALLASEY,43841,43765,99.3,90.7,90.5,83.9,83.9,0.0,0.0,0.0,0.6,0.0,99.6,43523,39765,39691,2,3,4,242,36766,36767,7,43680,0,8.7,90.5,0.0,0.0,0.0,0.0,0.5,3832,39691,2,1,1,238
E14001011,WALSALL NORTH,42054,41930,98.3,86.2,84.3,7.8,83.3,0.0,0.0,0.8,1.4,0.1,98.6,41359,36249,35464,1,1,356,571,3261,35027,33,41452,0,14.0,84.3,0.0,0.0,0.0,0.8,0.5,5895,35464,1,0,355,215
E14001012,WALSALL SOUTH,41629,41405,98.0,68.7,68.2,11.5,68.0,0.0,0.0,0.2,1.4,0.0,98.8,40814,28587,28388,1,19,77,591,4786,28309,4,41147,0,29.8,68.2,0.0,0.0,0.0,0.1,1.2,12426,28388,1,18,58,514
E14001013,WALTHAMSTOW,49945,49520,94.9,88.7,86.8,25.1,86.1,0.0,0.2,0.9,4.2,0.0,95.0,47417,44277,43371,0,94,465,2103,12542,42978,11,47463,0,8.1,86.8,0.0,0.0,0.2,0.7,3.3,4046,43371,0,94,371,1638
E14001014,WANSBECK,41525,41421,96.5,11.1,6.8,4.7,4.7,0.0,0.1,0.2,3.3,0.0,99.6,40070,4616,2841,17,48,81,1351,1937,1937,14,41341,0,89.7,6.8,0.0,0.0,0.1,0.1,3.1,37229,2841,17,31,33,1270
E14001015,WANTAGE,58995,58761,96.1,61.2,58.9,25.0,25.0,0.1,0.3,0.8,3.5,0.1,99.1,56670,36085,34727,59,183,453,2091,14755,14755,87,58456,0,37.2,58.9,0.0,0.1,0.2,0.5,2.8,21943,34727,59,124,270,1638
E14001016,WARLEY,41527,41369,99.1,87.1,85.6,37.4,85.1,0.0,0.0,0.1,0.6,0.0,99.1,41133,36164,35557,3,7,55,236,15534,35352,1,41167,0,13.4,85.6,0.0,0.0,0.0,0.1,0.4,5576,35557,3,4,48,181
E14001017,WARRINGTON NORTH,45830,45660,98.0,81.1,78.7,10.6,77.7,0.1,0.1,0.2,1.7,0.0,99.2,44895,37153,36082,35,53,97,765,4840,35609,8,45444,1029,19.2,78.7,2.2,0.1,0.0,0.1,1.5,8813,36082,35,18,44,668
E14001018,WARRINGTON SOUTH,54305,53560,96.3,78.7,77.1,17.4,75.9,0.0,0.1,0.2,2.3,0.0,97.9,52299,42725,41896,6,63,104,1261,9466,41232,26,53146,6,19.2,77.1,0.0,0.0,0.1,0.1,2.1,10403,41896,6,57,41,1157
E14001019,WARWICK AND LEAMINGTON,50984,50828,98.9,82.9,76.2,12.1,71.6,0.0,0.2,0.3,0.8,0.0,99.3,50415,42271,38868,4,107,165,413,6155,36522,12,50619,0,22.6,76.2,0.0,0.0,0.2,0.1,0.5,11547,38868,4,103,58,248
E14001020,WASHINGTON AND SUNDERLAND WEST,42014,41931,96.4,77.9,74.5,3.5,72.8,0.1,0.4,1.6,3.4,0.1,97.6,40495,32739,31296,47,182,679,1436,1469,30596,28,41012,0,21.9,74.5,0.0,0.1,0.3,1.2,1.8,9199,31296,47,135,497,757
E14001021,WATFORD,53551,53278,98.8,91.6,88.2,22.7,22.7,0.0,0.0,0.2,0.7,0.0,99.1,52889,49044,47251,0,25,105,389,12133,12135,0,53059,0,10.5,88.2,0.0,0.0,0.0,0.1,0.5,5638,47251,0,25,80,284
E14001022,WAVENEY,51787,51527,95.6,20.4,20.4,20.4,20.4,0.1,0.4,0.6,3.9,0.3,98.6,49529,10544,10543,41,229,329,1998,10543,10543,178,51053,0,75.3,20.4,0.0,0.1,0.4,0.2,3.2,38986,10543,41,188,100,1669
E14001023,WEALDEN,49749,49527,94.4,52.8,52.5,52.4,52.4,0.2,0.7,1.3,5.1,0.6,98.9,46977,26246,26116,83,329,628,2550,26083,26083,284,49218,0,41.9,52.5,0.0,0.2,0.5,0.6,3.9,20861,26116,83,246,299,1922
E14001024,WEAVER VALE,44519,44072,95.1,43.8,37.7,16.6,16.6,0.2,0.4,0.8,3.9,0.1,98.5,42350,19491,16786,92,200,353,1722,7382,7383,58,43869,0,57.4,37.7,0.0,0.2,0.2,0.3,3.1,25564,16786,92,108,153,1369
E14001025,WELLINGBOROUGH,52984,52893,98.4,76.2,75.0,23.5,75.0,0.0,0.2,0.5,1.4,0.1,99.2,52136,40349,39718,8,122,252,757,12462,39718,49,52586,28,23.4,75.0,0.1,0.0,0.2,0.2,1.0,12418,39718,8,114,130,505
E14001026,WELLS,53052,52777,93.1,44.7,36.6,31.0,31.0,0.3,0.8,1.7,6.3,0.3,97.2,49409,23721,19410,151,448,922,3368,16444,16444,139,51592,132,56.5,36.6,0.2,0.3,0.6,0.9,4.6,29999,19410,151,297,474,2446
E14001027,WELWYN HATFIELD,48332,48222,97.2,77.0,74.9,12.1,73.3,0.0,0.1,0.4,2.6,0.0,99.1,46976,37227,36219,9,43,182,1246,5846,35427,4,47886,0,22.3,74.9,0.0,0.0,0.1,0.3,2.2,10757,36219,9,34,139,1064
E14001028,WENTWORTH AND DEARNE,48142,47908,98.3,52.9,49.3,15.0,15.0,0.0,0.2,0.4,1.2,0.0,99.0,47313,25457,23741,3,108,205,595,7206,7207,9,47667,0,49.0,49.3,0.0,0.0,0.2,0.2,0.8,23572,23741,3,105,97,390
E14001029,WEST BROMWICH EAST,40147,40041,98.7,83.9,82.3,22.5,81.0,0.0,0.0,0.5,1.0,0.0,98.7,39624,33682,33031,13,18,207,417,9020,32523,3,39638,0,16.4,82.3,0.0,0.0,0.0,0.5,0.5,6593,33031,13,5,189,210
E14001030,WEST BROMWICH WEST,42634,42491,99.1,79.2,78.2,5.5,78.2,0.0,0.0,0.2,0.5,0.0,99.2,42268,33783,33341,0,9,64,223,2336,33327,0,42289,0,20.9,78.2,0.0,0.0,0.0,0.1,0.4,8927,33341,0,9,55,159
E14001031,WEST DORSET,53174,52949,92.3,14.6,12.6,11.1,11.1,0.2,1.0,2.0,7.2,0.5,97.6,49098,7753,6725,116,550,1055,3851,5908,5908,288,51890,813,79.7,12.6,1.5,0.2,0.8,0.9,5.3,42373,6725,116,434,505,2796
E14001032,WEST HAM,72142,71836,98.5,92.1,88.4,52.5,84.8,0.0,0.0,0.4,1.1,0.0,98.5,71041,66465,63773,1,12,277,795,37893,61165,0,71051,0,10.1,88.4,0.0,0.0,0.0,0.4,0.7,7268,63773,1,11,265,518
E14001033,WEST LANCASHIRE,44885,44720,95.4,54.4,45.2,38.8,39.0,0.2,0.8,1.3,4.3,0.1,98.8,42800,24411,20284,105,373,573,1920,17432,17503,40,44348,10856,50.2,45.2,24.2,0.2,0.6,0.4,3.0,22516,20284,105,268,200,1347
E14001034,WEST SUFFOLK,56300,56024,95.0,35.4,31.7,16.0,16.0,0.2,0.4,0.8,4.5,0.3,98.9,53474,19951,17845,117,252,431,2550,9007,9007,192,55688,238,63.3,31.7,0.4,0.2,0.2,0.3,3.8,35629,17845,117,135,179,2119
E14001035,WEST WORCESTERSHIRE,48162,47792,90.9,23.7,18.3,14.9,14.9,0.4,1.6,2.9,8.3,0.8,97.9,43802,11408,8791,196,753,1403,3990,7179,7179,391,47131,2079,72.7,18.3,4.3,0.4,1.2,1.3,5.4,35011,8791,196,557,650,2587
E14001036,WESTMINSTER NORTH,62967,62611,97.6,69.3,67.9,63.5,65.1,0.0,0.0,0.0,1.9,0.0,97.6,61435,43637,42761,0,0,2,1176,40001,40964,0,61445,0,29.7,67.9,0.0,0.0,0.0,0.0,1.9,18674,42761,0,0,2,1174
E14001037,WESTMORLAND AND LONSDALE,49897,49634,93.4,17.7,15.9,14.8,14.8,0.4,0.9,1.6,6.0,0.7,98.1,46626,8852,7948,189,453,810,3008,7371,7371,373,48971,19330,77.5,15.9,38.7,0.4,0.5,0.7,4.4,38678,7948,189,264,357,2198
E14001038,WESTON-SUPER-MARE,54980,54296,92.5,56.2,48.7,42.5,42.5,0.1,0.3,0.9,6.3,0.3,96.3,50849,30873,26801,62,163,519,3447,23341,23343,151,52928,0,43.7,48.7,0.0,0.1,0.2,0.6,5.3,24048,26801,62,101,356,2928
E14001039,WIGAN,50633,50584,98.0,88.5,86.4,4.1,85.8,0.0,0.1,0.4,1.9,0.0,99.2,49623,44816,43732,10,70,191,961,2068,43455,3,50249,23315,11.6,86.4,46.0,0.0,0.1,0.2,1.5,5891,43732,10,60,121,770
E14001040,WIMBLEDON,45711,45594,98.4,89.1,87.7,47.3,87.7,0.0,0.0,0.2,1.4,0.0,98.4,44971,40718,40101,1,11,102,623,21634,40101,1,44997,0,10.7,87.7,0.0,0.0,0.0,0.2,1.1,4870,40101,1,10,91,521
E14001041,WINCHESTER,45453,45271,94.7,56.4,56.1,3.9,4.7,0.2,0.6,1.1,4.9,0.2,98.5,43050,25652,25517,102,276,513,2221,1772,2154,91,44753,0,38.6,56.1,0.0,0.2,0.4,0.5,3.8,17533,25517,102,174,237,1708
E14001042,WINDSOR,49162,48970,95.3,66.2,63.2,21.9,31.8,0.0,0.1,0.5,4.3,0.1,97.7,46866,32545,31061,14,63,259,2104,10747,15656,29,48051,0,32.1,63.2,0.0,0.0,0.1,0.4,3.8,15805,31061,14,49,196,1845
E14001043,WIRRAL SOUTH,34730,34656,97.0,73.9,73.9,53.5,53.5,0.1,0.2,0.2,2.8,0.0,99.7,33673,25677,25676,39,60,82,983,18593,18593,0,34634,0,23.0,73.9,0.0,0.1,0.1,0.1,2.6,7997,25676,39,21,22,901
E14001044,WIRRAL WEST,33082,32985,95.3,38.1,38.1,27.7,27.7,0.0,0.1,0.3,4.4,0.1,98.7,31543,12598,12597,7,47,84,1442,9173,9173,17,32660,0,57.3,38.1,0.0,0.0,0.1,0.1,4.1,18946,12597,7,40,37,1358
E14001045,WITHAM,43455,43175,94.2,19.9,19.9,14.0,14.0,0.3,0.8,1.4,5.2,0.3,97.3,40928,8668,8668,113,338,614,2247,6062,6062,147,42299,4238,74.2,19.9,9.8,0.3,0.5,0.6,3.8,32260,8668,113,225,276,1633
E14001046,WITNEY,53358,53103,98.7,77.6,72.4,42.2,42.2,0.0,0.0,0.1,0.8,0.1,99.2,52680,41392,38655,10,22,57,423,22536,22536,74,52944,11,26.3,72.4,0.0,0.0,0.0,0.1,0.7,14025,38655,10,12,35,366
E14001047,WOKING,48348,47752,96.7,81.2,77.8,3.9,3.9,0.0,0.3,0.4,2.0,0.3,98.3,46765,39278,37616,3,151,178,987,1897,1898,122,47531,0,18.9,77.8,0.0,0.0,0.3,0.1,1.7,9149,37616,3,148,27,809
E14001048,WOKINGHAM,52336,51230,95.1,71.3,66.6,18.7,64.0,0.0,0.1,0.3,2.8,0.0,96.1,49781,37316,34849,5,67,182,1449,9779,33507,15,50298,2871,28.5,66.6,5.5,0.0,0.1,0.2,2.4,14932,34849,5,62,115,1267
E14001049,WOLVERHAMPTON NORTH EAST,41261,41165,98.7,92.2,91.2,7.4,90.7,0.0,0.0,0.1,1.1,0.0,98.9,40727,38030,37624,0,0,54,438,3033,37432,2,40803,90,7.5,91.2,0.2,0.0,0.0,0.1,0.9,3103,37624,0,0,54,384
E14001050,WOLVERHAMPTON SOUTH EAST,42583,42446,99.0,90.8,89.2,18.5,88.7,0.0,0.0,0.0,0.7,0.0,99.5,42136,38646,37983,0,2,10,310,7857,37771,0,42380,492,9.8,89.2,1.2,0.0,0.0,0.0,0.7,4153,37983,0,2,8,300
E14001051,WOLVERHAMPTON SOUTH WEST,40023,39934,97.8,93.4,91.0,17.7,89.8,0.0,0.0,0.0,1.9,0.0,97.9,39155,37367,36423,0,0,13,779,7104,35928,0,39182,5346,6.8,91.0,13.4,0.0,0.0,0.0,1.9,2732,36423,0,0,13,766
E14001052,WORCESTER,49068,48744,98.4,22.0,11.2,3.7,3.7,0.0,0.0,0.0,0.9,0.0,99.0,48279,10806,5479,0,0,23,465,1797,1797,16,48559,0,87.2,11.2,0.0,0.0,0.0,0.0,0.9,42800,5479,0,0,23,442
E14001053,WORKINGTON,41305,41094,93.5,3.0,3.0,3.0,3.0,0.9,1.4,2.3,6.0,0.7,98.7,38618,1244,1244,352,595,930,2476,1244,1244,272,40783,0,90.5,3.0,0.0,0.9,0.6,0.8,3.7,37374,1244,352,243,335,1546
E14001054,WORSLEY AND ECCLES SOUTH,50139,50060,98.3,94.3,94.3,74.6,94.3,0.0,0.2,0.6,1.5,0.0,98.5,49284,47304,47303,10,95,279,776,37404,47303,11,49405,0,4.0,94.3,0.0,0.0,0.2,0.4,1.0,1981,47303,10,85,184,497
E14001055,WORTHING WEST,49973,49887,98.7,76.9,71.7,48.9,48.9,0.0,0.0,0.0,1.1,0.0,99.7,49338,38437,35845,0,2,12,549,24455,24455,1,49846,0,27.0,71.7,0.0,0.0,0.0,0.0,1.1,13493,35845,0,2,10,537
E14001056,WYCOMBE,47689,47515,97.3,52.6,41.3,10.6,33.6,0.0,0.2,0.3,2.4,0.1,99.3,46383,25104,19709,17,88,148,1132,5064,16033,61,47350,6,55.9,41.3,0.0,0.0,0.1,0.1,2.1,26674,19709,17,71,60,984
E14001057,WYRE AND PRESTON NORTH,45892,45599,94.7,55.1,54.0,33.0,33.0,0.1,0.3,0.9,4.6,0.1,98.3,43482,25288,24770,53,134,398,2117,15129,15129,36,45114,17884,40.8,54.0,39.0,0.1,0.2,0.6,3.7,18712,24770,53,81,264,1719
E14001058,WYRE FOREST,48472,48204,96.7,48.5,48.1,2.6,48.1,0.1,0.3,0.7,2.8,0.2,99.1,46859,23514,23324,45,141,323,1345,1276,23324,94,48058,1662,48.6,48.1,3.4,0.1,0.2,0.4,2.1,23535,23324,45,96,182,1022
E14001059,WYTHENSHAWE AND SALE EAST,50275,50187,97.6,91.6,90.7,37.1,89.6,0.0,0.3,1.0,2.2,0.0,98.2,49063,46049,45598,12,167,514,1124,18677,45023,0,49372,53,6.9,90.7,0.1,0.0,0.3,0.7,1.2,3465,45598,12,155,347,610
E14001060,YEOVIL,55447,54848,90.9,14.2,14.2,14.2,14.2,0.4,1.6,2.6,8.1,0.5,97.5,50375,7884,7884,236,880,1437,4473,7884,7884,271,54055,13,76.6,14.2,0.0,0.4,1.2,1.0,5.5,42491,7884,236,644,557,3036
E14001061,YORK CENTRAL,52205,51847,94.0,86.3,82.6,62.4,79.3,0.0,0.1,0.5,5.3,0.0,94.2,49088,45047,43147,0,37,256,2759,32556,41390,0,49198,2099,11.4,82.6,4.0,0.0,0.1,0.4,4.8,5941,43147,0,37,219,2503
E14001062,YORK OUTER,43942,43791,94.5,66.9,64.8,58.0,63.3,0.1,0.3,0.9,5.2,0.1,98.3,41521,29419,28483,41,145,412,2270,25470,27799,32,43178,4761,29.7,64.8,10.8,0.1,0.2,0.6,4.2,13038,28483,41,104,267,1858
N06000001,BELFAST EAST,47186,46856,97.7,92.7,92.4,82.3,92.4,0.1,0.3,0.4,1.6,0.3,98.3,46120,43738,43584,24,121,189,736,38854,43584,152,46388,0,5.4,92.4,0.0,0.1,0.2,0.1,1.2,2536,43584,24,97,68,547
N06000002,BELFAST NORTH,52374,51935,97.9,94.0,93.9,80.4,93.9,0.0,0.1,0.5,1.2,0.2,98.2,51289,49238,49173,17,34,274,646,42096,49173,116,51421,0,4.0,93.9,0.0,0.0,0.0,0.5,0.7,2116,49173,17,17,240,372
N06000003,BELFAST SOUTH,56937,56370,97.8,91.6,91.4,77.5,91.4,0.0,0.1,0.3,1.2,0.3,97.9,55702,52132,52029,3,46,191,668,44144,52030,182,55768,0,6.5,91.4,0.0,0.0,0.1,0.3,0.8,3673,52029,3,43,145,477
N06000004,BELFAST WEST,41541,41326,98.8,92.3,92.1,82.3,92.1,0.0,0.1,0.1,0.7,0.3,99.1,41049,38329,38267,7,23,48,277,34203,38267,140,41155,0,6.7,92.1,0.0,0.0,0.0,0.1,0.6,2782,38267,7,16,25,229
N06000005,EAST ANTRIM,41166,40737,92.3,73.7,73.7,71.2,73.7,1.6,2.4,3.1,6.7,1.4,98.0,37988,30357,30357,650,992,1258,2749,29307,30357,562,40355,0,18.5,73.7,0.0,1.6,0.8,0.6,3.6,7631,30357,650,342,266,1491
N06000006,EAST LONDONDERRY,46795,45727,86.1,65.4,65.4,65.4,65.4,2.4,4.1,5.6,11.6,3.7,97.1,40306,30603,30601,1107,1933,2605,5421,30600,30601,1743,45447,0,20.7,65.4,0.0,2.4,1.8,1.4,6.0,9705,30601,1107,826,672,2816
N06000007,FERMANAGH AND SOUTH TYRONE,45682,45058,72.3,35.4,35.4,35.4,35.4,6.8,11.5,16.0,26.3,4.3,97.6,33022,16155,16154,3115,5257,7306,12036,16154,16154,1951,44606,19910,36.9,35.4,43.6,6.8,4.7,4.5,10.4,16868,16154,3115,2142,2049,4730
N06000008,FOYLE,43463,43363,97.4,90.2,90.2,77.5,90.2,0.4,0.5,0.8,2.3,0.2,99.3,42350,39201,39197,156,235,349,1013,33700,39197,73,43152,0,7.3,90.2,0.0,0.4,0.2,0.3,1.5,3153,39197,156,79,114,664
N06000009,LAGAN VALLEY,45821,45375,91.8,73.5,73.5,63.0,73.5,0.5,1.5,2.5,7.2,1.1,98.7,42075,33686,33686,207,707,1135,3300,28885,33686,516,45225,0,18.3,73.5,0.0,0.5,1.1,0.9,4.7,8389,33686,207,500,428,2165
N06000010,MID ULSTER,38483,37996,80.8,55.0,55.0,55.0,55.0,2.9,5.7,8.7,17.9,5.7,97.2,31103,21160,21160,1102,2211,3367,6893,21160,21160,2210,37417,0,25.8,55.0,0.0,2.9,2.9,3.0,9.2,9943,21160,1102,1109,1156,3526
N06000011,NEWRY AND ARMAGH,46142,45496,83.0,59.1,58.8,59.1,59.1,2.7,5.1,7.3,15.6,4.0,97.7,38302,27260,27123,1255,2336,3366,7194,27259,27260,1857,45093,1578,24.2,58.8,3.4,2.7,2.3,2.2,8.3,11179,27123,1255,1081,1030,3828
N06000012,NORTH ANTRIM,48039,47300,86.7,66.6,66.6,66.6,66.6,1.9,3.9,5.7,11.7,2.4,97.7,41662,31984,31984,912,1896,2741,5638,31981,31984,1163,46932,0,20.1,66.6,0.0,1.9,2.0,1.8,6.0,9678,31984,912,984,845,2897
N06000013,NORTH DOWN,42363,42253,98.2,89.1,89.1,86.3,89.1,0.1,0.3,0.5,1.5,0.1,99.7,41600,37755,37751,57,110,195,653,36573,37751,36,42234,0,9.1,89.1,0.0,0.1,0.1,0.2,1.1,3849,37751,57,53,85,458
N06000014,SOUTH ANTRIM,42194,41634,88.1,72.6,72.5,68.5,72.5,2.3,4.1,5.2,10.6,2.2,98.1,37179,30649,30608,953,1710,2213,4455,28908,30595,940,41403,0,15.6,72.5,0.0,2.3,1.8,1.2,5.3,6571,30608,953,757,503,2242
N06000015,SOUTH DOWN,44190,43326,87.3,69.3,69.3,69.3,69.3,1.8,3.8,5.6,10.7,3.1,96.2,38599,30602,30602,786,1700,2495,4727,30602,30602,1382,42493,865,18.1,69.3,2.0,1.8,2.1,1.8,5.1,7997,30602,786,914,795,2232
N06000016,STRANGFORD,39990,39713,89.8,71.7,71.7,71.7,71.7,1.0,2.4,4.3,9.5,1.7,98.9,35909,28660,28660,384,950,1731,3804,28659,28660,670,39566,0,18.1,71.7,0.0,1.0,1.4,2.0,5.2,7249,28660,384,566,781,2073
N06000017,UPPER BANN,52457,52194,94.6,78.6,78.6,78.6,78.6,0.4,0.8,1.3,4.9,0.5,99.2,49601,41254,41253,210,422,699,2593,41253,41253,280,52061,0,15.9,78.6,0.0,0.4,0.4,0.5,3.6,8348,41253,210,212,277,1894
N06000018,WEST TYRONE,38360,37645,75.2,52.0,52.0,52.0,52.0,7.2,11.4,14.3,23.0,7.6,97.1,28837,19954,19954,2780,4389,5493,8808,19953,19954,2909,37245,2505,23.2,52.0,6.5,7.2,4.2,2.9,8.6,8883,19954,2780,1609,1104,3315
S14000001,ABERDEEN NORTH,57740,57161,95.1,72.4,65.2,58.7,58.7,0.0,0.0,0.2,3.9,0.0,95.9,54915,41808,37655,2,14,129,2246,33888,33888,18,55352,0,29.9,65.2,0.0,0.0,0.0,0.2,3.7,17260,37655,2,12,115,2117
S14000002,ABERDEEN SOUTH,53642,53383,95.6,74.0,72.1,70.6,70.6,0.0,0.2,0.4,3.9,0.1,97.1,51279,39717,38663,23,91,189,2104,37897,37897,62,52101,0,23.5,72.1,0.0,0.0,0.1,0.2,3.6,12616,38663,23,68,98,1915
S14000003,AIRDRIE AND SHOTTS,41435,41348,97.2,67.6,67.4,8.5,67.4,0.1,0.3,0.7,2.6,0.2,99.2,40261,28004,27941,24,117,277,1087,3512,27941,99,41113,0,29.7,67.4,0.0,0.1,0.2,0.4,2.0,12320,27941,24,93,160,810
S14000004,ANGUS,46808,46237,85.9,13.6,13.6,13.6,13.6,1.5,4.2,7.5,12.9,2.7,94.3,40192,6362,6362,720,1957,3523,6045,6361,6361,1245,44163,0,72.3,13.6,0.0,1.5,2.6,3.3,5.4,33830,6362,720,1237,1566,2522
S14000005,ARGYLL AND BUTE,56695,54885,78.1,1.8,1.8,1.8,1.8,3.1,6.0,9.9,18.7,7.3,88.5,44270,1017,1017,1780,3403,5633,10615,1016,1017,4156,50167,0,76.3,1.8,0.0,3.1,2.9,3.9,8.8,43253,1017,1780,1623,2230,4982
S14000006,"AYR, CARRICK AND CUMNOCK",48205,48037,94.3,46.5,45.0,27.2,27.2,0.5,1.4,2.4,5.4,1.0,98.3,45447,22431,21682,253,661,1173,2590,13123,13123,461,47402,0,49.3,45.0,0.0,0.5,0.8,1.1,2.9,23765,21682,253,408,512,1417
S14000007,BANFF AND BUCHAN,46850,46480,84.5,6.0,6.0,6.0,6.0,2.3,5.3,8.5,14.7,2.9,94.6,39582,2823,2823,1096,2492,3977,6898,2823,2823,1358,44342,0,78.5,6.0,0.0,2.3,3.0,3.2,6.2,36759,2823,1096,1396,1485,2921
S14000008,"BERWICKSHIRE, ROXBURGH AND SELKIRK",54233,53140,84.8,18.2,14.7,12.3,12.3,2.0,4.5,7.5,13.1,3.2,94.1,46013,9854,7984,1071,2443,4091,7127,6674,6674,1740,51021,10075,70.1,14.7,18.6,2.0,2.5,3.0,5.6,38029,7984,1071,1372,1648,3036
S14000009,"CAITHNESS, SUTHERLAND AND EASTER ROSS",29511,28950,76.3,1.6,1.6,1.6,1.6,2.7,6.1,10.3,21.8,4.5,92.1,22529,458,458,793,1802,3038,6421,458,458,1333,27176,3034,74.8,1.6,10.3,2.7,3.4,4.2,11.5,22071,458,793,1009,1236,3383
S14000010,CENTRAL AYRSHIRE,44979,44845,95.3,72.1,72.1,17.7,17.7,0.2,0.7,1.7,4.4,0.4,98.8,42847,32448,32425,83,294,769,1998,7973,7973,174,44417,0,23.2,72.1,0.0,0.2,0.5,1.1,2.7,10422,32425,83,211,475,1229
S14000011,"COATBRIDGE, CHRYSTON AND BELLSHILL",46540,46382,98.2,86.3,84.7,23.8,84.0,0.1,0.5,0.7,1.5,0.1,98.6,45682,40157,39416,39,242,324,700,11072,39108,65,45898,0,13.5,84.7,0.0,0.1,0.4,0.2,0.8,6266,39416,39,203,82,376
S14000012,"CUMBERNAULD, KILSYTH AND KIRKINTILLOCH EAST",43135,42959,95.9,70.4,68.6,17.8,68.1,0.1,0.4,1.0,3.7,0.1,98.9,41359,30364,29595,43,182,431,1600,7681,29361,43,42681,0,27.3,68.6,0.0,0.1,0.3,0.6,2.7,11764,29595,43,139,249,1169
S14000013,DUMFRIES AND GALLOWAY,54261,53182,86.1,8.3,8.3,8.3,8.3,1.6,3.6,6.1,11.9,3.5,95.2,46712,4509,4509,868,1945,3323,6470,4509,4509,1902,51658,0,77.8,8.3,0.0,1.6,2.0,2.5,5.8,42203,4509,868,1077,1378,3147
S14000014,"DUMFRIESSHIRE, CLYDESDALE AND TWEEDDALE",45755,44946,84.3,17.2,17.2,17.2,17.2,1.8,4.2,7.4,13.9,3.6,94.6,38584,7860,7859,840,1916,3395,6362,7859,7859,1639,43274,0,67.2,17.2,0.0,1.8,2.4,3.2,6.5,30725,7859,840,1076,1479,2967
S14000015,DUNDEE EAST,44315,44216,96.5,81.8,80.2,4.9,4.9,0.2,0.5,1.2,3.3,0.1,98.8,42747,36239,35542,78,222,516,1469,2163,2163,63,43783,0,16.3,80.2,0.0,0.2,0.3,0.7,2.2,7205,35542,78,144,294,953
S14000016,DUNDEE WEST,49826,49692,97.8,88.6,86.3,34.2,34.2,0.1,0.2,0.6,1.9,0.1,98.8,48752,44136,42980,73,113,275,940,17033,17033,32,49219,0,11.6,86.3,0.0,0.1,0.1,0.3,1.3,5772,42980,73,40,162,665
S14000017,DUNFERMLINE AND WEST FIFE,51072,50881,96.9,57.2,56.4,56.2,56.2,0.3,0.8,1.1,2.8,0.3,99.3,49476,29233,28830,144,387,551,1405,28704,28704,134,50717,0,40.4,56.4,0.0,0.3,0.5,0.3,1.7,20646,28830,144,243,164,854
S14000018,EAST DUNBARTONSHIRE,38190,37956,97.0,85.5,84.5,22.4,83.6,0.0,0.1,0.3,2.4,0.0,98.0,37047,32660,32254,4,27,102,909,8573,31924,11,37430,0,12.6,84.5,0.0,0.0,0.1,0.2,2.1,4793,32254,4,23,75,807
S14000019,"EAST KILBRIDE, STRATHAVEN AND LESMAHAGOW",50353,50188,95.9,71.8,71.7,15.0,71.7,0.5,1.0,2.0,3.8,0.2,98.3,48276,36160,36100,241,516,1001,1912,7553,36100,109,49497,0,24.2,71.7,0.0,0.5,0.5,1.0,1.8,12176,36100,241,275,485,911
S14000020,EAST LOTHIAN,49334,49132,92.5,33.4,33.4,33.4,33.4,0.4,1.4,2.4,7.1,0.3,97.4,45621,16482,16480,199,706,1197,3511,16478,16482,165,48075,17805,59.1,33.4,36.1,0.4,1.0,1.0,4.7,29141,16480,199,507,491,2314
S14000021,EAST RENFREWSHIRE,41194,41172,95.9,70.9,70.4,9.1,70.3,0.1,0.2,0.6,4.1,0.1,98.9,39501,29191,28983,38,99,233,1671,3759,28946,41,40751,0,25.5,70.4,0.0,0.1,0.1,0.3,3.5,10518,28983,38,61,134,1438
S14000022,EDINBURGH EAST,55856,55831,96.6,85.3,84.3,64.7,84.0,0.0,0.1,0.4,3.3,0.0,96.7,53963,47663,47113,0,46,248,1868,36130,46901,0,54004,0,12.3,84.3,0.0,0.0,0.1,0.4,2.9,6850,47113,0,46,202,1620
S14000023,EDINBURGH NORTH AND LEITH,68162,68073,97.9,87.0,84.8,33.4,82.8,0.0,0.1,0.3,1.9,0.0,98.0,66753,59330,57799,0,50,186,1320,22795,56444,0,66789,5,13.1,84.8,0.0,0.0,0.1,0.2,1.7,8954,57799,0,50,136,1134
S14000024,EDINBURGH SOUTH,42417,42130,98.2,91.6,90.4,58.2,89.6,0.0,0.1,0.1,1.1,0.0,98.4,41665,38852,38329,1,23,33,465,24681,38006,0,41750,0,7.9,90.4,0.0,0.0,0.1,0.0,1.0,3336,38329,1,22,10,432
S14000025,EDINBURGH SOUTH WEST,54136,54111,98.0,94.3,91.5,55.5,90.5,0.1,0.2,0.3,2.0,0.0,98.5,53048,51072,49531,63,84,171,1063,30042,48968,12,53342,0,6.5,91.5,0.0,0.1,0.0,0.2,1.6,3517,49531,63,21,87,892
S14000026,EDINBURGH WEST,45671,45653,97.4,85.1,83.8,64.5,83.3,0.1,0.5,0.9,2.6,0.1,98.8,44487,38879,38256,49,220,391,1166,29475,38043,43,45133,0,13.6,83.8,0.0,0.1,0.4,0.4,1.7,6231,38256,49,171,171,775
S14000027,NA H-EILEANAN AN IAR,16684,15209,75.7,4.5,4.5,4.5,4.5,2.5,3.9,5.1,15.5,6.1,87.9,12626,750,750,425,649,853,2583,750,750,1016,14673,0,71.2,4.5,0.0,2.5,1.3,1.2,10.4,11876,750,425,224,204,1730
S14000028,FALKIRK,51070,51028,97.1,86.1,86.0,10.6,85.9,0.1,0.3,0.6,2.8,0.1,98.8,49606,43990,43913,34,153,295,1422,5430,43856,45,50471,0,11.1,86.0,0.0,0.1,0.2,0.3,2.2,5693,43913,34,119,142,1127
S14000029,GLASGOW CENTRAL,63983,63075,90.1,63.5,56.9,29.0,53.9,0.0,0.0,0.2,8.5,0.0,90.4,57624,40636,36414,0,4,146,5451,18530,34511,0,57870,0,33.1,56.9,0.0,0.0,0.0,0.2,8.3,21210,36414,0,4,142,5305
S14000030,GLASGOW EAST,48284,48141,98.5,80.6,77.8,49.3,75.0,0.0,0.0,0.5,1.2,0.0,98.8,47563,38940,37569,0,12,226,578,23787,36234,1,47694,0,20.7,77.8,0.0,0.0,0.0,0.4,0.7,9994,37569,0,12,214,352
S14000031,GLASGOW NORTH,42674,42341,98.5,82.3,74.7,9.9,69.1,0.0,0.1,0.2,0.7,0.0,98.8,42024,35104,31898,14,25,69,317,4232,29478,0,42141,0,23.7,74.7,0.0,0.0,0.0,0.1,0.6,10126,31898,14,11,44,248
S14000032,GLASGOW NORTH EAST,45418,45229,98.5,81.1,74.6,17.4,69.3,0.0,0.0,0.1,1.1,0.0,99.1,44745,36844,33869,0,4,61,484,7921,31484,4,45009,0,23.9,74.6,0.0,0.0,0.0,0.1,0.9,10876,33869,0,4,57,423
S14000033,GLASGOW NORTH WEST,45863,45775,99.4,82.1,74.8,3.9,68.6,0.0,0.0,0.0,0.4,0.0,99.6,45581,37640,34294,3,4,21,194,1773,31469,0,45671,0,24.6,74.8,0.0,0.0,0.0,0.0,0.4,11287,34294,3,1,17,173
S14000034,GLASGOW SOUTH,46112,46032,97.4,71.7,64.5,5.6,58.2,0.0,0.0,0.2,2.4,0.0,97.9,44914,33078,29742,1,13,100,1118,2569,26845,0,45155,0,32.9,64.5,0.0,0.0,0.0,0.2,2.2,15172,29742,1,12,87,1018
S14000035,GLASGOW SOUTH WEST,44270,44182,99.0,80.2,78.7,65.0,77.8,0.0,0.1,0.2,0.8,0.0,99.5,43841,35501,34843,16,65,80,341,28764,34421,0,44039,0,20.3,78.7,0.0,0.0,0.1,0.0,0.6,8998,34843,16,49,15,261
S14000036,GLENROTHES,45508,45317,96.6,72.9,72.6,6.0,6.0,0.1,0.2,0.8,3.0,0.0,98.9,43964,33184,33061,57,109,368,1353,2722,2722,12,45028,0,24.0,72.6,0.0,0.1,0.1,0.6,2.2,10903,33061,57,52,259,985
S14000037,GORDON,50569,50279,84.9,26.7,25.8,25.4,25.4,1.9,4.2,7.1,14.6,2.6,95.4,42909,13516,13047,938,2147,3615,7370,12826,12826,1314,48226,0,59.1,25.8,0.0,1.9,2.4,2.9,7.4,29862,13047,938,1209,1468,3755
S14000038,INVERCLYDE,41970,41917,96.6,73.4,73.1,10.3,73.1,0.1,0.4,0.7,3.3,0.1,98.4,40543,30786,30673,42,148,294,1374,4314,30673,61,41310,0,23.5,73.1,0.0,0.1,0.3,0.3,2.6,9870,30673,42,106,146,1080
S14000039,"INVERNESS, NAIRN, BADENOCH AND STRATHSPEY",52938,52373,89.7,45.5,45.5,45.5,45.5,1.2,2.6,4.2,9.2,2.4,96.3,47498,24067,24067,651,1358,2199,4875,24067,24067,1281,51000,286,44.3,45.5,0.5,1.2,1.3,1.6,5.1,23431,24067,651,707,841,2676
S14000040,KILMARNOCK AND LOUDOUN,48122,47970,95.9,55.6,55.6,46.4,46.4,0.6,1.0,1.8,3.8,0.2,98.6,46128,26758,26757,276,494,864,1842,22342,22342,107,47472,0,40.3,55.6,0.0,0.6,0.5,0.8,2.0,19371,26757,276,218,370,978
S14000041,KIRKCALDY AND COWDENBEATH,51984,51570,96.9,70.9,70.9,29.5,29.5,0.1,0.2,0.3,2.3,0.1,98.4,50384,36859,36837,43,104,179,1186,15350,15350,34,51163,0,26.1,70.9,0.0,0.1,0.1,0.1,1.9,13547,36837,43,61,75,1007
S14000042,LANARK AND HAMILTON EAST,51487,51386,95.4,67.9,67.8,26.3,67.8,0.4,1.0,2.0,4.4,0.2,98.9,49140,34940,34895,189,528,1046,2246,13552,34895,113,50937,0,27.7,67.8,0.0,0.4,0.7,1.0,2.3,14245,34895,189,339,518,1200
S14000043,LINLITHGOW AND EAST FALKIRK,56728,56589,96.9,81.5,81.2,41.2,81.0,0.1,0.4,1.0,2.9,0.2,98.9,54966,46260,46043,61,230,565,1623,23373,45922,126,56124,2,15.7,81.2,0.0,0.1,0.3,0.6,1.9,8923,46043,61,169,335,1058
S14000044,LIVINGSTON,53007,52863,97.1,82.0,80.3,32.7,79.1,0.2,0.4,1.1,2.6,0.2,98.5,51484,43466,42554,94,196,575,1379,17334,41929,105,52230,0,16.8,80.3,0.0,0.2,0.2,0.7,1.5,8930,42554,94,102,379,804
S14000045,MIDLOTHIAN,42787,42347,93.6,58.6,58.5,58.5,58.6,0.7,1.3,2.4,5.3,0.4,97.8,40063,25054,25041,289,570,1012,2284,25039,25053,179,41841,2012,35.1,58.5,4.7,0.7,0.7,1.0,3.0,15022,25041,289,281,442,1272
S14000046,MORAY,49558,49109,84.5,22.2,22.2,22.2,22.2,1.7,4.5,7.1,14.6,2.9,95.3,41852,10991,10991,849,2229,3495,7257,10991,10991,1456,47216,16964,62.3,22.2,34.2,1.7,2.8,2.6,7.6,30861,10991,849,1380,1266,3762
S14000047,MOTHERWELL AND WISHAW,46575,46514,98.9,88.3,87.9,9.2,87.8,0.0,0.0,0.2,1.0,0.0,99.4,46042,41115,40952,0,12,111,472,4298,40880,3,46273,0,10.9,87.9,0.0,0.0,0.0,0.2,0.8,5090,40952,0,12,99,361
S14000048,NORTH AYRSHIRE AND ARRAN,50587,50341,92.8,13.1,13.1,13.1,13.1,0.5,1.0,1.8,6.7,0.3,98.7,46960,6622,6622,260,512,913,3381,6622,6622,172,49932,0,79.7,13.1,0.0,0.5,0.5,0.8,4.9,40338,6622,260,252,401,2468
S14000049,NORTH EAST FIFE,43375,42659,89.8,18.8,18.1,12.7,12.7,0.6,1.9,3.6,8.6,0.6,96.4,38944,8145,7840,270,823,1568,3715,5509,5509,278,41798,0,71.7,18.1,0.0,0.6,1.3,1.7,4.9,31104,7840,270,553,745,2147
S14000050,OCHIL AND SOUTH PERTHSHIRE,52036,51718,88.7,22.8,17.9,15.8,15.8,1.3,2.9,4.9,10.7,1.1,97.2,46151,11842,9294,664,1535,2567,5567,8217,8217,597,50579,0,70.8,17.9,0.0,1.3,1.7,2.0,5.8,36857,9294,664,871,1032,3000
S14000051,ORKNEY AND SHETLAND,24755,23719,66.9,1.6,1.6,1.6,1.6,3.5,8.2,18.4,28.9,7.4,79.7,16563,395,395,867,2036,4555,7156,395,395,1831,19738,0,65.3,1.6,0.0,3.5,4.7,10.2,10.5,16168,395,867,1169,2519,2601
S14000052,PAISLEY AND RENFREWSHIRE NORTH,47700,47581,95.9,84.2,84.2,40.3,68.7,0.1,0.3,0.9,3.9,0.1,97.6,45735,40163,40148,45,160,418,1846,19206,32764,41,46559,0,11.7,84.2,0.0,0.1,0.2,0.5,3.0,5587,40148,45,115,258,1428
S14000053,PAISLEY AND RENFREWSHIRE SOUTH,47582,47512,97.6,83.7,83.6,34.3,83.6,0.1,0.3,0.5,2.3,0.1,98.9,46423,39805,39797,61,135,230,1089,16320,39797,25,47082,0,13.9,83.6,0.0,0.1,0.2,0.2,1.8,6626,39797,61,74,95,859
S14000054,PERTH AND NORTH PERTHSHIRE,53264,52716,86.9,50.1,48.7,5.3,5.3,1.3,3.4,6.0,12.1,2.1,95.0,46293,26674,25966,679,1785,3177,6423,2801,2801,1113,50613,1,38.2,48.7,0.0,1.3,2.1,2.6,6.1,20327,25966,679,1106,1392,3246
S14000055,"ROSS, SKYE AND LOCHABER",33246,31763,74.3,4.4,4.4,4.4,4.4,3.6,6.4,11.1,21.2,5.6,89.2,24713,1469,1469,1185,2140,3679,7050,1469,1469,1847,29671,2058,69.9,4.4,6.2,3.6,2.9,4.6,10.1,23244,1469,1185,955,1539,3371
S14000056,RUTHERGLEN AND HAMILTON WEST,52490,52406,98.7,88.6,87.6,19.6,86.6,0.0,0.1,0.1,1.2,0.0,99.4,51782,46482,45974,24,52,71,624,10286,45436,17,52170,0,11.1,87.6,0.0,0.0,0.1,0.0,1.1,5808,45974,24,28,19,553
S14000057,STIRLING,46487,45914,88.7,52.6,50.2,49.3,49.4,1.4,3.0,4.7,10.1,2.5,96.0,41221,24445,23357,641,1394,2204,4693,22941,22949,1145,44612,0,38.4,50.2,0.0,1.4,1.6,1.7,5.4,17864,23357,641,753,810,2489
S14000058,WEST ABERDEENSHIRE AND KINCARDINE,45394,44846,81.5,10.2,10.0,9.8,9.8,2.7,5.8,9.6,17.3,4.6,93.8,37014,4643,4550,1210,2653,4349,7832,4453,4453,2068,42577,0,71.5,10.0,0.0,2.7,3.2,3.7,7.7,32464,4550,1210,1443,1696,3483
S14000059,WEST DUNBARTONSHIRE,47127,47091,98.3,89.6,88.4,1.3,87.3,0.0,0.2,0.5,1.6,0.0,99.0,46325,42247,41650,23,92,226,766,612,41119,16,46675,0,9.9,88.4,0.0,0.0,0.1,0.3,1.1,4675,41650,23,69,134,540
W07000041,YNYS MÔN,37531,36990,88.9,16.9,16.9,16.9,16.9,0.8,2.1,3.6,9.6,1.5,95.2,33375,6359,6333,306,776,1353,3615,6359,6359,560,35722,9447,72.1,16.9,25.2,0.8,1.3,1.5,6.0,27042,6333,306,470,577,2262
W07000042,DELYN,34372,34176,93.1,52.2,47.4,44.7,44.7,0.4,1.3,2.6,6.3,0.4,97.1,32007,17955,16287,140,434,906,2169,15375,15375,134,33367,12197,45.7,47.4,35.5,0.4,0.9,1.4,3.7,15720,16287,140,294,472,1263
W07000043,ALYN AND DEESIDE,40322,40141,96.4,73.4,68.9,66.3,66.3,0.2,0.8,1.5,3.1,0.4,98.2,38873,29599,27785,97,319,619,1268,26738,26738,158,39580,17126,27.5,68.9,42.5,0.2,0.6,0.7,1.6,11088,27785,97,222,300,649
W07000044,WREXHAM,35461,34803,95.6,60.1,60.1,60.1,60.1,0.0,0.2,0.6,2.6,0.9,96.6,33889,21329,21328,16,85,229,914,21328,21328,333,34261,15399,35.4,60.1,43.4,0.0,0.2,0.4,1.9,12561,21328,16,69,144,685
W07000045,LLANELLI,40800,40588,94.8,42.6,42.6,42.6,42.6,0.4,1.0,1.9,4.7,0.4,97.8,38690,17383,17383,177,405,792,1898,17379,17383,153,39912,479,52.2,42.6,1.2,0.4,0.6,0.9,2.7,21307,17383,177,228,387,1106
W07000046,GOWER,38527,38408,95.8,62.6,59.3,30.5,52.8,0.3,0.7,1.4,3.9,0.4,97.6,36905,24120,22854,118,264,557,1503,11758,20346,163,37588,13480,36.5,59.3,35.0,0.3,0.4,0.8,2.5,14051,22854,118,146,293,946
W07000047,SWANSEA WEST,40048,39961,99.3,91.8,89.3,35.8,64.2,0.0,0.0,0.1,0.5,0.0,99.6,39752,36780,35778,0,0,22,209,14345,25730,2,39868,18600,9.9,89.3,46.4,0.0,0.0,0.1,0.5,3974,35778,0,0,22,187
W07000048,SWANSEA EAST,40405,40073,97.8,88.0,86.3,29.4,44.6,0.0,0.0,0.3,1.4,0.0,98.4,39501,35569,34864,1,10,107,572,11884,18027,5,39755,26503,11.5,86.3,65.6,0.0,0.0,0.2,1.2,4637,34864,1,9,97,465
W07000049,ABERAVON,33031,32972,97.2,76.3,76.2,4.0,57.3,0.1,0.2,0.4,2.6,0.1,98.8,32120,25187,25181,29,71,123,852,1309,18934,30,32621,14468,21.0,76.2,43.8,0.1,0.1,0.2,2.2,6939,25181,29,42,52,729
W07000050,CARDIFF CENTRAL,40320,40068,95.7,82.5,80.1,53.6,78.3,0.0,0.1,0.2,3.7,0.0,95.7,38573,33255,32286,0,28,96,1495,21615,31568,0,38601,26153,15.6,80.1,64.9,0.0,0.1,0.2,3.5,6287,32286,0,28,68,1399
W07000051,CARDIFF NORTH,40025,39957,98.0,88.2,85.1,65.3,82.8,0.0,0.2,0.6,1.8,0.0,99.4,39234,35306,34046,18,79,233,723,26124,33143,3,39773,28364,13.0,85.1,70.9,0.0,0.2,0.4,1.2,5188,34046,18,61,154,490
W07000052,RHONDDA,35771,35596,98.6,1.6,1.6,1.6,1.6,0.0,0.0,0.0,0.9,0.0,99.5,35261,563,563,1,2,3,335,563,563,1,35585,1979,97.0,1.6,5.5,0.0,0.0,0.0,0.9,34698,563,1,1,1,332
W07000053,TORFAEN,41367,41117,95.6,47.6,38.8,7.3,7.3,0.1,0.5,1.4,3.8,0.3,97.1,39558,19695,16044,57,209,566,1559,3028,3028,104,40158,26176,56.8,38.8,63.3,0.1,0.4,0.9,2.4,23514,16044,57,152,357,993
W07000054,MONMOUTH,42170,41803,85.3,30.3,23.4,18.8,18.8,1.5,3.7,6.6,13.9,2.7,94.9,35955,12778,9847,642,1552,2804,5848,7935,7935,1135,40031,3846,61.9,23.4,9.1,1.5,2.2,3.0,7.2,26108,9847,642,910,1252,3044
W07000055,NEWPORT EAST,37888,37742,97.4,72.3,67.1,8.2,8.2,0.1,0.4,0.9,2.2,0.2,98.1,36919,27402,25417,27,143,328,823,3108,3108,67,37185,9784,30.4,67.1,25.8,0.1,0.3,0.5,1.3,11502,25417,27,116,185,495
W07000056,NEWPORT WEST,42880,42748,97.4,67.8,64.0,10.1,10.1,0.1,0.2,0.4,2.3,0.1,98.4,41747,29087,27438,38,101,190,1001,4343,4343,45,42174,14902,33.4,64.0,34.8,0.1,0.1,0.2,1.9,14309,27438,38,63,89,811
W07000057,ARFON,29528,29307,92.9,22.1,18.5,16.4,16.4,0.5,1.3,2.8,6.3,0.7,95.9,27437,6525,5477,139,373,813,1870,4831,4831,198,28310,11920,74.4,18.5,40.4,0.5,0.8,1.5,3.6,21960,5477,139,234,440,1057
W07000058,ABERCONWY,30277,30211,94.4,11.4,11.4,11.4,11.4,0.5,1.5,2.6,5.4,1.1,97.5,28586,3459,3459,164,466,798,1625,3459,3459,332,29527,14813,83.0,11.4,48.9,0.5,1.0,1.1,2.7,25127,3459,164,302,332,827
W07000059,CLWYD WEST,36933,36743,89.7,10.5,10.5,10.5,10.5,1.4,3.1,5.4,9.8,2.1,95.1,33125,3871,3871,503,1131,2003,3618,3871,3871,774,35137,19927,79.2,10.5,54.0,1.4,1.7,2.4,4.4,29254,3871,503,628,872,1615
W07000060,VALE OF CLWYD,38189,37856,94.7,26.1,26.1,26.1,26.1,0.1,0.4,1.2,4.4,0.3,96.7,36178,9964,9964,36,138,450,1678,9964,9964,109,36932,15160,68.6,26.1,39.7,0.1,0.3,0.8,3.2,26214,9964,36,102,312,1228
W07000061,DWYFOR MEIRIONNYDD,38577,38119,83.4,17.7,17.7,17.7,17.7,1.9,4.7,7.8,15.5,3.1,91.1,32157,6825,6825,732,1828,3013,5962,6825,6825,1204,35143,4,65.7,17.7,0.0,1.9,2.8,3.1,7.6,25332,6825,732,1096,1185,2949
W07000062,CLWYD SOUTH,34853,34574,91.8,20.1,19.1,18.2,18.2,0.8,2.1,3.7,7.4,1.1,96.3,31983,6994,6655,271,724,1302,2591,6326,6326,387,33565,13435,72.7,19.1,38.5,0.8,1.3,1.7,3.7,25328,6655,271,453,578,1289
W07000063,MONTGOMERYSHIRE,32449,31949,80.7,21.3,21.3,21.3,21.3,3.2,6.8,10.8,17.8,5.7,90.6,26172,6921,6920,1034,2197,3508,5777,6920,6920,1841,29395,3512,59.3,21.3,10.8,3.2,3.6,4.0,7.0,19252,6920,1034,1163,1311,2269
W07000064,CEREDIGION,37692,37326,81.2,21.8,21.8,21.8,21.8,2.8,6.4,10.6,17.8,4.5,89.3,30609,8230,8230,1074,2428,4004,6717,8230,8230,1702,33648,156,59.4,21.8,0.4,2.8,3.6,4.2,7.2,22379,8230,1074,1354,1576,2713
W07000065,PRESELI PEMBROKESHIRE,40727,40537,85.9,9.5,9.5,9.5,9.5,2.3,5.1,8.1,13.6,2.9,94.0,34998,3874,3874,928,2081,3317,5539,3874,3874,1162,38289,424,76.4,9.5,1.0,2.3,2.8,3.0,5.5,31124,3874,928,1153,1236,2222
W07000066,CARMARTHEN WEST AND SOUTH PEMBROKESHIRE,41903,41624,87.9,19.9,19.9,19.9,19.9,1.6,3.5,5.7,11.4,2.3,95.0,36841,8354,8354,662,1476,2381,4783,8349,8354,944,39819,89,68.0,19.9,0.2,1.6,1.9,2.2,5.7,28487,8354,662,814,905,2402
W07000067,CARMARTHEN EAST AND DINEFWR,36125,35429,78.7,18.5,18.5,18.5,18.5,3.2,6.8,10.5,19.4,4.1,87.7,28435,6682,6682,1151,2472,3811,6994,6682,6682,1464,31667,518,60.2,18.5,1.4,3.2,3.7,3.7,8.8,21753,6682,1151,1321,1339,3183
W07000068,BRECON AND RADNORSHIRE,37199,36386,76.7,14.9,14.9,14.9,14.9,3.5,7.0,11.3,21.1,4.4,86.1,28533,5533,5533,1306,2599,4218,7853,5531,5533,1635,32013,541,61.8,14.9,1.5,3.5,3.5,4.4,9.8,23000,5533,1306,1293,1619,3635
W07000069,NEATH,35950,35895,96.6,43.7,43.7,4.8,4.8,0.1,0.2,0.4,3.2,0.1,99.4,34735,15704,15702,24,67,150,1160,1718,1728,39,35745,7964,52.9,43.7,22.2,0.1,0.1,0.2,2.8,19033,15702,24,43,83,1010
W07000070,CYNON VALLEY,35760,35427,96.7,25.0,22.4,20.6,20.6,0.1,0.2,0.3,2.3,0.3,98.8,34594,8952,8017,29,58,103,833,7380,7383,93,35328,7846,74.3,22.4,21.9,0.1,0.1,0.1,2.0,26577,8017,29,29,45,730
W07000071,MERTHYR TYDFIL AND RHYMNEY,36342,36222,98.3,35.8,35.8,35.8,35.8,0.1,0.2,0.3,1.3,0.0,99.4,35733,13019,13019,25,57,126,489,13014,13019,8,36126,2902,62.5,35.8,8.0,0.1,0.1,0.2,1.0,22714,13019,25,32,69,363
W07000072,BLAENAU GWENT,35332,35200,96.2,5.3,3.9,2.8,2.8,0.0,0.3,0.7,3.4,0.2,99.2,33986,1888,1379,15,93,238,1214,974,974,55,35041,18,92.3,3.9,0.1,0.0,0.2,0.4,2.8,32607,1379,15,78,145,976
W07000073,BRIDGEND,39255,39125,98.2,64.8,58.4,55.3,55.3,0.0,0.1,0.3,1.5,0.0,99.1,38531,25420,22922,7,31,110,594,21692,21716,3,38888,18562,39.8,58.4,47.3,0.0,0.1,0.2,1.2,15609,22922,7,24,79,484
W07000074,OGMORE,36391,36181,96.0,27.7,18.8,13.3,13.3,0.1,0.2,0.7,3.4,0.0,98.8,34937,10088,6839,27,57,259,1244,4848,4849,13,35960,8219,77.2,18.8,22.6,0.1,0.1,0.6,2.7,28098,6839,27,30,202,985
W07000075,PONTYPRIDD,39610,39369,96.4,56.4,52.0,27.1,49.0,0.1,0.1,0.6,3.0,0.0,98.0,38183,22334,20608,22,38,257,1186,10752,19422,1,38828,19923,44.4,52.0,50.3,0.1,0.0,0.6,2.3,17575,20608,22,16,219,929
W07000076,CAERPHILLY,40220,40042,98.2,43.1,38.0,34.4,34.4,0.0,0.1,0.2,1.4,0.0,99.4,39481,17346,15294,16,47,75,561,13845,13852,10,39977,27940,60.1,38.0,69.5,0.0,0.1,0.1,1.2,24187,15294,16,31,28,486
W07000077,ISLWYN,35513,35366,97.7,28.2,27.7,27.3,27.3,0.1,0.1,0.3,1.9,0.1,99.4,34685,10023,9826,21,50,104,681,9709,9709,21,35298,11150,70.0,27.7,31.4,0.1,0.1,0.2,1.6,24859,9826,21,29,54,577
W07000078,VALE OF GLAMORGAN,48971,48549,96.0,63.1,60.1,53.1,58.0,0.3,0.8,1.3,3.2,0.6,97.7,47003,30911,29442,136,415,655,1546,25984,28400,284,47848,1026,35.9,60.1,2.1,0.3,0.6,0.5,1.8,17561,29442,136,279,240,891
W07000079,CARDIFF WEST,44425,44197,98.9,86.5,84.2,28.5,82.8,0.0,0.0,0.1,0.6,0.0,99.3,43947,38423,37411,6,19,26,250,12679,36772,17,44122,23556,14.7,84.2,53.0,0.0,0.0,0.0,0.5,6536,37411,6,13,7,224
W07000080,CARDIFF SOUTH AND PENARTH,56059,55624,97.4,85.1,82.1,38.1,80.4,0.0,0.7,1.3,1.9,0.0,97.5,54582,47693,46028,8,383,709,1042,21336,45060,15,54663,30490,15.3,82.1,54.4,0.0,0.7,0.6,0.6,8554,46028,8,375,326,333
